Day,Market Participant,Tape A Shares,Tape B Shares,Tape C Shares,Total Shares,Tape A Notional,Tape B Notional,Tape C Notional,Total Notional,Tape A Trade Count,Tape B Trade Count,Tape C Trade Count,Total Trade Count
2022-06-30,NYSE American (A),15150186,29292338,14281846,58724370,493112526.015700,747532989.180100,550093813.022500,1790739328.218300,174254,108555,118403,401212
2022-06-30,NASDAQ BX (B),22540493,17751058,23664894,63956445,939175008.351500,1320141406.914100,1246421708.165200,3505738123.430800,509988,146415,425086,1081489
2022-06-30,NYSE National (C),38861536,30209154,30018709,99089399,895693846.783000,1304835686.740600,859066072.990400,3059595606.514000,423548,168976,293131,885655
2022-06-30,FINRA / Nasdaq TRF Chicago (DB),8254037,3079858,13034872,24368767,269071805.563100,196926169.788700,783888121.220700,1249886096.572500,33354,12542,55187,101083
2022-06-30,FINRA / NYSE TRF (DN),244526595,130233248,568875427,943635270,7215110360.355998,5668879894.914802,16746102971.556315,29630093226.827115,1253315,311710,1515937,3080962
2022-06-30,FINRA / Nasdaq TRF Carteret (DQ),1446702539,836718860,2134128235,4417549634,54260930649.873410,48363643942.107631,77063095267.173411,179687669859.154452,6810290,2199236,6849080,15858606
2022-06-30,MIAX Pearl (H),38844647,30764932,38866948,108476527,878956353.387600,1635040087.302700,1599971269.264300,4113967709.954600,369773,135846,361559,867178
2022-06-30,EDGA Equities (J),69527613,41077479,68415286,179020378,2331863420.432900,2089176297.046200,2670378342.415000,7091418059.894100,980604,301064,794135,2075803
2022-06-30,EDGX Equities (K),220394823,117784261,316137280,654316364,6884630442.319298,6846819832.738102,11240592342.707304,24972042617.764704,2066922,668483,2038418,4773823
2022-06-30,LTSE (L),250722,107004,70290,428016,16066372.360000,12383636.420000,10146631.800000,38596640.580000,446,1013,613,2072
2022-06-30,NYSE Chicago (M),7899719,13464832,10710757,32075308,510087256.642800,2819839795.077200,2110632655.288301,5440559707.008301,53563,4839,41624,100026
2022-06-30,NYSE (N),1256597302,49269875,81721440,1387588617,59337600066.783788,3262427439.943000,3351798226.353601,65951825733.080389,4848740,249425,669080,5767245
2022-06-30,NYSE Arca (P),241722979,421200296,438821981,1101745256,8321206096.723097,25951620320.889800,17820974381.376689,52093800798.989586,2371759,1751588,3358217,7481564
2022-06-30,NASDAQ (Q),529205795,263472197,1284702589,2077380581,22302805406.296602,18460032524.110400,67647050051.089137,108409887981.496139,7045967,1839715,9373438,18259120
2022-06-30,Members Exchange (U),200966774,107644416,181135318,489746508,4865302363.519300,5862756343.107099,5817351902.133601,16545410608.760000,1577825,606829,1407179,3591833
2022-06-30,Investors Exchange (V),166399194,38115227,130925414,335439835,8749185123.105501,2627486589.622500,7825110700.909800,19201782413.637801,2099713,242834,1640693,3983240
2022-06-30,NASDAQ PSX (X),26682078,34178576,34414053,95274707,671213611.914300,1820778890.607800,1505219209.052400,3997211711.574500,218011,155306,270921,644238
2022-06-30,BYX Equities (Y),72962352,44315624,55778730,173056706,1636048186.360900,2708061102.137900,1896100168.565200,6240209457.064000,701943,258945,571833,1532721
2022-06-30,BZX Equities (Z),232589220,173439220,228816885,634845325,8186716499.538502,12772833139.320503,11044740039.735892,32004289678.594897,2959650,1172144,2440757,6572551
2022-06-29,NYSE American (A),15510285,25376246,13692937,54579468,465836136.189200,557419858.884400,418422942.782400,1441678937.856000,163403,98305,118963,380671
2022-06-29,NASDAQ BX (B),21152400,11857716,21764405,54774521,875532051.436800,772144157.769100,1060407025.333300,2708083234.539200,469645,96475,397276,963396
2022-06-29,NYSE National (C),38591347,23421375,27117712,89130434,851740753.684200,1003350042.956500,726276197.440300,2581366994.081000,397955,133692,292888,824535
2022-06-29,FINRA / Nasdaq TRF Chicago (DB),6537406,2783776,13102415,22423597,211819915.227300,160624612.034900,616932890.894900,989377418.157100,26577,9983,49094,85654
2022-06-29,FINRA / NYSE TRF (DN),230029521,122613054,657201556,1009844131,6424928633.711300,4164525579.506099,14128220621.559095,24717674834.776494,1137467,254671,1446109,2838247
2022-06-29,FINRA / Nasdaq TRF Carteret (DQ),1313855354,662489038,2232627147,4208971539,46686540376.403982,34191817926.891399,65336019136.882767,146214377440.178148,6137278,1912314,6418540,14468132
2022-06-29,MIAX Pearl (H),35601936,25060522,37077789,97740247,759362145.013900,1179853522.809600,1246179698.942600,3185395366.766100,341309,110264,348186,799759
2022-06-29,EDGA Equities (J),65796001,29669779,67338696,162804476,2107749654.701900,1505839252.956300,2133857759.667300,5747446667.325500,892030,223260,760377,1875667
2022-06-29,EDGX Equities (K),205318606,90376452,334768959,630464017,6183899535.561500,4806163863.066699,8945156594.567998,19935219993.196197,1912898,498347,1940546,4351791
2022-06-29,LTSE (L),123989,20809,72280,217078,5161279.280000,706936.590000,11809206.763700,17677422.633700,263,13,552,828
2022-06-29,NYSE Chicago (M),10316036,9257485,8556198,28129719,598852040.857200,737218743.130100,1439986791.373500,2776057575.360800,38011,3581,32133,73725
2022-06-29,NYSE (N),920627804,34768152,74157583,1029553539,37988144082.320104,2231719213.907600,2616805319.320300,42836668615.548004,4082396,178391,615910,4876697
2022-06-29,NYSE Arca (P),222578910,309296027,475028303,1006903240,7188107282.601798,17959799696.961808,14151289403.739503,39299196383.303109,2100772,1388899,3187161,6676832
2022-06-29,NASDAQ (Q),482515755,191120465,1104391759,1778027979,19239521332.899506,12654556455.786804,45918188110.922479,77812265899.608789,6381168,1419042,8451733,16251943
2022-06-29,Members Exchange (U),182926617,76188275,165096331,424211223,4148774677.565000,4131837191.353600,4466090233.754700,12746702102.673300,1419548,466613,1284902,3171063
2022-06-29,Investors Exchange (V),148182148,27170674,116173501,291526323,7491481275.483900,1880291296.165501,6382770226.571201,15754542798.220602,2029124,194639,1598558,3822321
2022-06-29,NASDAQ PSX (X),26465616,25696712,24800855,76963183,603655438.818200,1231856159.110700,961058511.123700,2796570109.052600,199638,115458,219618,534714
2022-06-29,BYX Equities (Y),72508821,30216678,53544867,156270366,1510447468.284600,1854786967.001999,1509094157.697700,4874328592.984299,650008,171180,531474,1352662
2022-06-29,BZX Equities (Z),212604318,131941144,224351985,568897447,7039978206.400101,9246390343.199599,8651036016.554400,24937404566.154100,2641990,964434,2304515,5910939
2022-06-28,NYSE American (A),14991898,23393881,14488940,52874719,519009210.768600,694858760.900700,503567250.973300,1717435222.642600,167871,93774,124789,386434
2022-06-28,NASDAQ BX (B),20867525,13812012,22293365,56972902,958179875.522800,967184632.533000,1195270663.491400,3120635171.547200,496513,103467,417166,1017146
2022-06-28,NYSE National (C),43791443,24280775,28964010,97036228,990222711.132600,1095971208.966000,851674628.781800,2937868548.880400,463180,147673,330461,941314
2022-06-28,FINRA / Nasdaq TRF Chicago (DB),6892886,2905767,13653769,23452422,296029409.968000,133155346.230600,726892811.674600,1156077567.873200,33211,10979,55085,99275
2022-06-28,FINRA / NYSE TRF (DN),237059796,117513879,588710672,943284347,7696720694.384702,5308906288.901803,15222496679.931502,28228123663.218007,1213291,292250,1562522,3068063
2022-06-28,FINRA / Nasdaq TRF Carteret (DQ),1362287678,749918513,2140645325,4252851516,55644170769.806782,45009982218.076688,70837528841.861703,171491681829.745173,6456843,2121649,6879904,15458396
2022-06-28,MIAX Pearl (H),40876459,25015999,34763250,100655708,882165494.603600,1310412198.976300,1392390634.392400,3584968327.972300,368933,115920,350881,835734
2022-06-28,EDGA Equities (J),66162831,29793900,65080106,161036837,2279765623.412200,1610203240.488400,2382232281.471300,6272201145.371900,979779,221653,804976,2006408
2022-06-28,EDGX Equities (K),211938961,92580033,322116477,626635471,7330726702.149702,5228492588.088999,10600172178.945100,23159391469.183801,1963238,535560,1994230,4493028
2022-06-28,LTSE (L),27772,31918,25659,85349,2267524.420000,2207862.540000,2690912.780000,7166299.740000,381,94,344,819
2022-06-28,NYSE Chicago (M),8580589,8313516,7831399,24725504,560578776.334100,903884468.295000,1027593178.942200,2492056423.571300,45204,3859,37292,86355
2022-06-28,NYSE (N),929264617,39641043,77824948,1046730608,41723085008.858294,2746668389.110499,2979663020.878000,47449416418.846793,4449816,197548,625956,5273320
2022-06-28,NYSE Arca (P),218789034,322583793,424667412,966040239,7726529619.779804,21236488099.761090,15621497993.606211,44584515713.147105,2172485,1400281,3303245,6876011
2022-06-28,NASDAQ (Q),487496713,197780136,1104407984,1789684833,20644725227.766602,13868147284.284704,54534839260.484110,89047711772.535416,6607333,1456280,8824363,16887976
2022-06-28,Members Exchange (U),170094406,75431705,179902240,425428351,4339421945.052399,4364899716.237600,5252920851.092501,13957242512.382500,1461374,474868,1356704,3292946
2022-06-28,Investors Exchange (V),147652765,30940436,117589260,296182461,7994189722.842000,2133928351.694200,6962365507.316002,17090483581.852202,2049790,202077,1563816,3815683
2022-06-28,NASDAQ PSX (X),24001857,28846928,29333936,82182721,584693966.287000,1454949769.285700,1089161897.751600,3128805633.324300,204522,128457,253652,586631
2022-06-28,BYX Equities (Y),62746974,32376471,51900399,147023844,1449133842.374000,2083488376.879501,1708856740.460400,5241478959.713901,625766,191840,540879,1358485
2022-06-28,BZX Equities (Z),216603079,144948458,209029337,570580874,7899806248.036301,10391650829.153104,9734271997.332099,28025729074.521504,2784310,1047790,2312184,6144284
2022-06-27,NYSE American (A),13576599,22115678,13408908,49101185,438369307.667000,583450182.958900,404529812.550900,1426349303.176800,157657,92375,120275,370307
2022-06-27,NASDAQ BX (B),21528390,11952039,20793864,54274293,954007508.715900,895342498.055100,1021002158.741800,2870352165.512800,471757,101574,397389,970720
2022-06-27,NYSE National (C),33610987,20052484,23777633,77441104,797276513.558800,860927297.292000,629261714.317600,2287465525.168400,376769,124001,273320,774090
2022-06-27,FINRA / Nasdaq TRF Chicago (DB),6651934,2452932,13416731,22521597,259930700.288900,156800121.799300,734285433.637600,1151016255.725800,31792,9783,56759,98334
2022-06-27,FINRA / NYSE TRF (DN),239701007,106774336,505024184,851499527,7401004411.484484,4937872182.632000,14128617679.470604,26467494273.587088,1294296,278531,1551552,3124379
2022-06-27,FINRA / Nasdaq TRF Carteret (DQ),1399178868,678534559,1970855128,4048568555,52830867193.638501,40059349125.926614,73668039473.391747,166558255792.956862,6622323,2226830,6625738,15474891
2022-06-27,MIAX Pearl (H),38239722,25299576,34037270,97576568,921696883.779500,1258942335.595999,1217305227.638500,3397944447.013999,378701,113243,342089,834033
2022-06-27,EDGA Equities (J),64147739,29534223,61551133,155233095,2109816843.898000,1584047845.666300,2121222655.758900,5815087345.323200,902767,224928,755716,1883411
2022-06-27,EDGX Equities (K),211176544,87607881,296899919,595684344,7027791992.014496,4982445986.821599,9397040107.447208,21407278086.283303,1943083,521910,1894189,4359182
2022-06-27,LTSE (L),34667,10116,18167,62950,1866236.160000,637629.350000,756084.266000,3259949.776000,420,113,245,778
2022-06-27,NYSE Chicago (M),5596185,6791942,7065228,19453355,487149010.741900,746427951.199300,1850956652.200500,3084533614.141700,42517,3674,35415,81606
2022-06-27,NYSE (N),991242568,36897149,73381648,1101521365,44258385806.124105,2464774892.145800,2657168502.349301,49380329200.619206,4443743,195902,620071,5259716
2022-06-27,NYSE Arca (P),221514095,297151410,418361736,937027241,7702652031.027902,18164246677.934901,14413730506.203897,40280629215.166700,2194400,1344995,3241461,6780856
2022-06-27,NASDAQ (Q),474366226,181703279,1069624976,1725694481,19622913877.107396,12735947370.013308,52533914349.449698,84892775596.570402,6441968,1376660,8816735,16635363
2022-06-27,Members Exchange (U),166724714,73132206,154571262,394428182,4181392941.298201,3931723665.756898,4406886757.809702,12520003364.864801,1441157,446398,1284097,3171652
2022-06-27,Investors Exchange (V),142023880,28826776,114351499,285202155,7442366193.522700,2143501823.962400,6356920002.583201,15942788020.068301,1933630,222697,1545342,3701669
2022-06-27,NASDAQ PSX (X),23321724,26628330,26150328,76100382,550496554.309800,1284650957.193000,946196272.928400,2781343784.431200,201172,124609,229710,555491
2022-06-27,BYX Equities (Y),62410553,29682205,51014054,143106812,1454433842.810600,1865038534.033099,1419496027.323100,4738968404.166799,624784,188243,522052,1335079
2022-06-27,BZX Equities (Z),210264206,130395572,193564113,534223891,7409687827.872399,9389209156.431098,8249031904.839599,25047928889.143096,2639066,946278,2221314,5806658
2022-06-24,NYSE American (A),19436456,152603507,15798345,187838308,611999639.762500,1257042367.861300,500570712.315000,2369612719.938800,206458,128918,156485,491861
2022-06-24,NASDAQ BX (B),27739995,17114255,29605034,74459284,1205231130.130400,1205192721.606900,1336528288.718000,3746952140.455300,591826,135599,509992,1237417
2022-06-24,NYSE National (C),55668855,33050152,39516352,128235359,1272774350.447800,1443930362.697100,970722660.797500,3687427373.942400,584858,183883,419379,1188120
2022-06-24,FINRA / Nasdaq TRF Chicago (DB),9030404,2540611,13549959,25120974,363898622.467500,125331681.680000,655676294.296100,1144906598.443600,38952,10748,54778,104478
2022-06-24,FINRA / NYSE TRF (DN),275490216,123087114,482020586,880597916,8829226290.602101,5333985108.996197,14465732484.495892,28628943884.094190,1435277,296894,1592403,3324574
2022-06-24,FINRA / Nasdaq TRF Carteret (DQ),2440303480,833054567,2841232958,6114591005,102756521582.978683,49711486713.188485,102061744402.919967,254529752699.087135,8127245,2149374,7747398,18024017
2022-06-24,MIAX Pearl (H),39341157,26332910,43302896,108976963,1013851625.983500,1367009819.941000,1352987837.574100,3733849283.498600,422401,125188,405436,953025
2022-06-24,EDGA Equities (J),88899515,39285782,71349133,199534430,3141437439.581100,2163192940.207200,2555937015.780500,7860567395.568800,1243834,281784,958887,2484505
2022-06-24,EDGX Equities (K),272615510,109371200,310826175,692812885,9559916716.033998,6082692935.891401,11660481014.616000,27303090666.541399,2461100,607550,2269594,5338244
2022-06-24,LTSE (L),101221,18703,26484,146408,3836437.650000,200914.930000,1018368.778700,5055721.358700,268,24,276,568
2022-06-24,NYSE Chicago (M),7338663,11718223,9246917,28303803,542337216.350200,1130972257.394600,1642575271.813900,3315884745.558700,49784,5165,43004,97953
2022-06-24,NYSE (N),3200159982,46956575,94165431,3341281988,115358055584.809289,3191817921.131301,3547295773.040998,122097169278.981588,5193689,222174,803155,6219018
2022-06-24,NYSE Arca (P),277273788,382988175,422904582,1083166545,10323149027.810297,24255800599.970169,16737302977.122602,51316252604.903068,2767526,1572591,3659725,7999842
2022-06-24,NASDAQ (Q),627752609,234222706,4397896870,5259872185,26659473284.654097,16737826646.922102,112167186053.800220,155564485985.376419,8080093,1633763,10755596,20469452
2022-06-24,Members Exchange (U),205319665,88360122,188859367,482539154,5520892490.367500,4805065034.693001,5467188713.614500,15793146238.675001,1847424,512673,1597673,3957770
2022-06-24,Investors Exchange (V),199162116,39918970,161430336,400511422,10154142634.580800,2851859907.971401,8439073957.247303,21445076499.799504,2523964,279680,2124117,4927761
2022-06-24,NASDAQ PSX (X),29010922,31955873,29712935,90679730,806299975.611500,1657958547.696800,1170099405.799400,3634357929.107700,274999,144396,293621,713016
2022-06-24,BYX Equities (Y),76458200,43621934,65194590,185274724,1908700552.319100,2653060056.376001,1936554139.191500,6498314747.886601,785053,251751,680585,1717389
2022-06-24,BZX Equities (Z),269159745,159905638,251491705,680557088,10056361729.521799,11238355254.052499,11618174626.382795,32912891609.957093,3310109,1069238,2765116,7144463
2022-06-23,NYSE American (A),18894712,26943928,13054894,58893534,564285760.447100,771612676.778300,460635565.289400,1796534002.514800,192494,120756,131640,444890
2022-06-23,NASDAQ BX (B),24410558,18113954,22630841,65155353,1061279146.000100,1257686719.193200,1208847201.108800,3527813066.302100,523461,144472,434284,1102217
2022-06-23,NYSE National (C),48533314,30407509,32797742,111738565,943522861.407800,1191396105.867800,803564181.704400,2938483148.980000,461679,155156,333345,950180
2022-06-23,FINRA / Nasdaq TRF Chicago (DB),8189780,3072202,12265779,23527761,287129158.411400,147538890.020000,765279524.874300,1199947573.305700,36577,10755,58603,105935
2022-06-23,FINRA / NYSE TRF (DN),270220771,125208221,521618611,917047603,8608555147.584204,5072489309.154397,15784617222.420999,29465661679.159600,1386486,295784,1539709,3221979
2022-06-23,FINRA / Nasdaq TRF Carteret (DQ),1610395598,783896124,2003500624,4397792346,61370512918.751088,44640325224.919606,73316469230.073155,179327307373.743849,7723816,2148461,7276396,17148673
2022-06-23,MIAX Pearl (H),46788591,33573509,36381769,116743869,1034112700.066600,1542376905.383200,1279519212.661000,3856008818.110800,405743,145510,365745,916998
2022-06-23,EDGA Equities (J),81405062,40338887,60380229,182124178,2758836566.615700,1998267059.986400,2385170433.430300,7142274060.032400,1125284,305308,849874,2280466
2022-06-23,EDGX Equities (K),272704224,117737471,307789068,698230763,8965714762.493598,6280657105.545201,11331772563.086001,26578144431.124800,2439634,669766,2151356,5260756
2022-06-23,LTSE (L),48571,4408,64607,117586,2708401.960000,141039.160000,9791469.544500,12640910.664500,277,44,369,690
2022-06-23,NYSE Chicago (M),12405044,11732186,12294746,36431976,740593677.272700,1191966993.367200,1524177956.099200,3456738626.739100,53532,5754,42280,101566
2022-06-23,NYSE (N),1093169803,50110136,84375218,1227655157,47362515226.200710,3168685743.669300,3271275204.560099,53802476174.430109,5204944,253123,709268,6167335
2022-06-23,NYSE Arca (P),273656446,388723205,405740446,1068120097,9588220241.531501,23100642165.255202,16185371827.594098,48874234234.380801,2664164,1679377,3518300,7861841
2022-06-23,NASDAQ (Q),584397806,250477359,1131444462,1966319627,23658547042.281304,15858246196.767607,55028500219.303201,94545293458.352112,7704694,1813768,9873235,19391697
2022-06-23,Members Exchange (U),202852996,100891450,169931492,473675938,5142294940.577000,5141062368.740300,5406518047.831097,15689875357.148397,1768535,578995,1483220,3830750
2022-06-23,Investors Exchange (V),186159900,38547639,140610840,365318379,9547743002.168400,2467962755.764900,7496799919.315899,19512505677.249199,2365750,272897,1831253,4469900
2022-06-23,NASDAQ PSX (X),31272632,35772812,29126157,96171601,720724971.527700,1532349805.505300,1290644379.530500,3543719156.563500,257022,153646,278751,689419
2022-06-23,BYX Equities (Y),71165677,41633190,52856482,165655349,1677799630.015300,2533167971.226600,1725701584.427800,5936669185.669700,737508,247156,573957,1558621
2022-06-23,BZX Equities (Z),261968764,182361358,221336443,665666565,9212764139.144598,12438130071.832308,10590243923.401504,32241138134.378410,3264079,1278824,2589186,7132089
2022-06-22,NYSE American (A),16481267,32458534,12363257,61303058,472449322.230300,744461097.018400,438122089.926700,1655032509.175400,174490,111171,125826,411487
2022-06-22,NASDAQ BX (B),24093759,15822573,23204566,63120898,1005559216.921400,1064589139.804700,1144188898.564700,3214337255.290800,529193,122676,428655,1080524
2022-06-22,NYSE National (C),46493123,28424219,31611947,106529289,962318145.520000,1150152821.270900,842004727.736200,2954475694.527100,480816,154530,355449,990795
2022-06-22,FINRA / Nasdaq TRF Chicago (DB),7580728,2660625,11020896,21262249,264554205.944200,133740812.929700,758309138.614800,1156604157.488700,31448,10001,51602,93051
2022-06-22,FINRA / NYSE TRF (DN),260606674,125465207,519776925,905848806,7488455337.180296,5522505190.365795,15416384897.050403,28427345424.596494,1307519,289785,1412658,3009962
2022-06-22,FINRA / Nasdaq TRF Carteret (DQ),1592104604,751529600,1987808569,4331442773,57596022184.121617,43080014333.361529,74632417383.117397,175308453900.600543,7317646,2080495,6617797,16015938
2022-06-22,MIAX Pearl (H),53333402,31749606,35382058,120465066,1073580458.203500,1573740209.281400,1304025144.052800,3951345811.537700,396846,135139,336757,868742
2022-06-22,EDGA Equities (J),76604526,36450538,61190526,174245590,2460084765.799000,1891359500.600800,2398871293.938300,6750315560.338100,1037254,267678,799784,2104716
2022-06-22,EDGX Equities (K),251338313,107630549,290877861,649846723,7649943907.003698,6173293185.076901,10856990670.704810,24680227762.785409,2222028,588606,1926250,4736884
2022-06-22,LTSE (L),95060,53322,75580,223962,4430813.620000,5555427.100000,22149297.890200,32135538.610200,401,580,892,1873
2022-06-22,NYSE Chicago (M),11969786,18570128,13426669,43966583,689518394.035900,2816527586.455000,2486259020.845100,5992305001.336000,54237,5473,39123,98833
2022-06-22,NYSE (N),1216817596,45904943,77704397,1340426936,52973883555.203497,2895588318.596500,3002680788.555801,58872152662.355798,4699964,230935,628722,5559621
2022-06-22,NYSE Arca (P),268639986,369005631,395211063,1032856680,8382018898.874897,21771284158.246396,15501795742.739402,45655098799.860695,2528250,1540982,3230637,7299869
2022-06-22,NASDAQ (Q),539865451,228509463,1205172754,1973547668,21618469549.154498,15450462552.846599,56597613759.325791,93666545861.326888,7115595,1661622,8991968,17769185
2022-06-22,Members Exchange (U),186225169,86146416,152932606,425304191,4540857023.888999,4854522776.997701,4845954360.287799,14241334161.174499,1555610,500252,1268513,3324375
2022-06-22,Investors Exchange (V),163231524,34980573,128626596,326838693,8268734728.472598,2263877012.522800,7042374171.960701,17574985912.956099,2118840,232789,1654593,4006222
2022-06-22,NASDAQ PSX (X),27372367,34736817,26870403,88979587,638405437.037900,1585410480.438500,1066959706.238900,3290775623.715300,236385,154582,232794,623761
2022-06-22,BYX Equities (Y),73482036,36874113,49224421,159580570,1583281401.556300,2240882758.770600,1619533434.126100,5443697594.453000,698969,217007,523993,1439969
2022-06-22,BZX Equities (Z),242662874,170876469,215705358,629244701,8223884815.470099,12240977921.718101,9863510635.000403,30328373372.188603,2957494,1128229,2362529,6448252
2022-06-21,NYSE American (A),16140000,32891936,12892973,61924909,519835118.047100,665364178.875000,455089455.464100,1640288752.386200,177321,105077,146572,428970
2022-06-21,NASDAQ BX (B),25316360,14847914,23798134,63962408,999245323.066300,929156856.549200,1223010836.578300,3151413016.193800,522668,125939,461711,1110318
2022-06-21,NYSE National (C),46974510,28948127,32025804,107948441,930235497.934800,1090549545.355901,807105968.270600,2827891011.561301,454595,155357,352304,962256
2022-06-21,FINRA / Nasdaq TRF Chicago (DB),7843093,3164884,12161802,23169779,259060427.947600,146337185.862800,714779224.005000,1120176837.815400,33433,10732,55077,99242
2022-06-21,FINRA / NYSE TRF (DN),283159095,129668638,456800451,869628184,7760832075.042693,5220406538.043099,15393140349.314901,28374378962.400693,1419161,323139,1647473,3389773
2022-06-21,FINRA / Nasdaq TRF Carteret (DQ),1707493043,878571189,1978187779,4564252011,62340384425.893602,47444141502.452899,83238894133.513977,193023420061.860478,7839418,2379083,7555951,17774452
2022-06-21,MIAX Pearl (H),47438968,24706828,35489972,107635768,1057383362.526200,1199155847.013500,1247228044.413700,3503767253.953400,424851,118111,371736,914698
2022-06-21,EDGA Equities (J),77105424,33730623,65454110,176290157,2546481302.714900,1700851688.376000,2449598765.186500,6696931756.277400,1069782,258635,875472,2203889
2022-06-21,EDGX Equities (K),270570928,107775158,278505912,656851998,8277666538.890203,5712956249.315301,11214649170.974102,25205271959.179606,2312471,588658,2096101,4997230
2022-06-21,LTSE (L),23140,168123,26224,217487,1444383.870000,41549363.120000,1147136.920000,44140883.910000,248,1034,308,1590
2022-06-21,NYSE Chicago (M),18919313,10621671,16519284,46060268,1345780595.545000,1673863380.635300,2621231656.306499,5640875632.486799,49234,4948,39533,93715
2022-06-21,NYSE (N),1261030624,38920411,81073336,1381024371,54984950708.961690,2635522095.457300,3124618068.375600,60745090872.794590,4775619,215810,699466,5690895
2022-06-21,NYSE Arca (P),262270155,370916420,364466807,997653382,8404621809.731601,21831428045.976492,16250553490.833207,46486603346.541300,2513836,1502572,3445067,7461475
2022-06-21,NASDAQ (Q),566787535,210206335,1272105859,2049099729,23091649399.238301,14041632503.183398,63497947075.177312,100631228977.599011,7415264,1580840,9918107,18914211
2022-06-21,Members Exchange (U),188198678,84050699,165025471,437274848,4665621718.484901,4636140213.933100,5173230489.893302,14474992422.311303,1605893,491850,1432496,3530239
2022-06-21,Investors Exchange (V),170876146,37637455,140324928,348838529,8494353015.368398,2557724946.005600,8214698593.679301,19266776555.053299,2086175,255175,1760588,4101938
2022-06-21,NASDAQ PSX (X),27172423,28423248,26018891,81614562,614577039.081600,1286131598.501300,1004649879.211700,2905358516.794600,239769,133146,249890,622805
2022-06-21,BYX Equities (Y),69880527,38061631,50849846,158792004,1644526256.241300,2183066683.086500,1790843204.774200,5618436144.102000,705568,222228,582277,1510073
2022-06-21,BZX Equities (Z),245066367,144807174,214540681,604414222,8509107645.994500,9994037500.225303,9987836593.017000,28490981739.236803,3081078,982032,2580215,6643325
2022-06-17,NYSE American (A),25045516,130524762,17198326,172768604,784647951.077500,1331191928.365500,682659378.585000,2798499258.028000,256388,142750,179875,579013
2022-06-17,NASDAQ BX (B),31174763,20738978,28687048,80600789,1254882330.848600,1307441454.471600,1396352224.857000,3958676010.177200,671341,167391,555067,1393799
2022-06-17,NYSE National (C),65143913,36987810,40405073,142536796,1492313491.290200,1489915605.986900,1056650079.548300,4038879176.825400,655160,204992,430912,1291064
2022-06-17,FINRA / Nasdaq TRF Chicago (DB),7927647,2706520,11223103,21857270,290456127.639200,140514208.530800,661996295.882800,1092966632.052800,35957,12477,49922,98356
2022-06-17,FINRA / NYSE TRF (DN),294228664,146825874,440492955,881547493,8940655887.010497,5999655244.725000,15111816097.007694,30052127228.743191,1506567,341217,1557746,3405530
2022-06-17,FINRA / Nasdaq TRF Carteret (DQ),2178176052,1046880472,2336066701,5561123225,86073666255.428810,61414365922.784381,97140034516.783546,244628066694.996737,8729853,2615096,7432450,18777399
2022-06-17,MIAX Pearl (H),59170343,37278202,36319487,132768032,1271503770.779800,1841190596.211199,1220750127.140700,4333444494.131699,469147,181153,351330,1001630
2022-06-17,EDGA Equities (J),103783646,49491565,77989713,231264924,3397043874.617700,2706537755.680801,3034977898.300400,9138559528.598901,1392233,382048,1036194,2810475
2022-06-17,EDGX Equities (K),322385902,130726412,302116491,755228805,10159448930.212694,7693469297.558304,11724544089.386594,29577462317.157592,2903298,808573,2317445,6029316
2022-06-17,LTSE (L),27472,20103,28318,75893,2246801.900000,1483277.850000,628268.079600,4358347.829600,295,5,344,644
2022-06-17,NYSE Chicago (M),15029807,14689708,15345890,45065405,920296055.958200,1522405079.121600,2550304516.410099,4993005651.489899,71442,6905,54117,132464
2022-06-17,NYSE (N),3379180757,60484625,106096630,3545762012,151200373165.061000,3932598153.737399,3929529388.120700,159062500706.919099,6625814,322285,887002,7835101
2022-06-17,NYSE Arca (P),365380264,469827860,419819991,1255028115,13561071249.562007,28764959599.859092,18867590640.937002,61193621490.358101,3742755,2085940,4026590,9855285
2022-06-17,NASDAQ (Q),727156933,300861969,2914074996,3942093898,29145599087.770799,20208863250.910103,126748544330.198315,176103006668.879217,9496378,2267126,11698263,23461767
2022-06-17,Members Exchange (U),244598302,118513608,184229219,547341129,6147020060.335800,6616066183.628800,5657522266.237499,18420608510.202099,2038351,702667,1608543,4349561
2022-06-17,Investors Exchange (V),217245131,45974033,159386459,422605623,10560026190.036199,3158495255.775200,8372372977.255599,22090894423.066998,2681036,305382,2055251,5041669
2022-06-17,NASDAQ PSX (X),41902649,40982276,35462926,118347851,1155523864.920700,2033497455.054899,1485601441.300500,4674622761.276099,378973,194097,333757,906827
2022-06-17,BYX Equities (Y),99594312,48582773,63160525,211337610,2318858878.502100,2857974143.627201,2128972095.232800,7305805117.362101,994378,299426,710157,2003961
2022-06-17,BZX Equities (Z),343592344,204870074,264730703,813193121,11782726962.973298,14471314676.921001,12489633504.649799,38743675144.544098,4173261,1470577,3146127,8789965
2022-06-16,NYSE American (A),22020860,39573611,17193671,78788142,674635047.069500,1058036930.719700,745281798.581600,2477953776.370800,226604,141548,169378,537530
2022-06-16,NASDAQ BX (B),30291343,23474297,30493652,84259292,1228547622.808000,1610563621.082000,1564279416.457100,4403390660.347100,695446,171243,572120,1438809
2022-06-16,NYSE National (C),54341935,43456932,39793315,137592182,1191736966.915100,1823962033.373400,1164183377.807200,4179882378.095700,602817,241505,443782,1288104
2022-06-16,FINRA / Nasdaq TRF Chicago (DB),9765903,3615550,13320732,26702185,317755970.504600,180020248.602100,814758572.349300,1312534791.456000,41876,15450,65133,122459
2022-06-16,FINRA / NYSE TRF (DN),277862489,152683434,492691029,923236952,8512728667.176505,6348194886.980101,15679673082.781898,30540596636.938504,1512075,414776,1738287,3665138
2022-06-16,FINRA / Nasdaq TRF Carteret (DQ),1636579199,1017894138,2033705128,4688178465,62454603701.289607,61907662983.460070,80301587987.316476,204663854672.066153,8703100,3157158,8211767,20072025
2022-06-16,MIAX Pearl (H),49252417,43189517,39531811,131973745,1103137955.973300,2184746191.135600,1517646702.503500,4805530849.612400,445858,191803,381194,1018855
2022-06-16,EDGA Equities (J),88475127,58344912,73283846,220103885,2928922775.090800,2862032297.931099,2967470787.002899,8758425860.024798,1249386,399965,988089,2637440
2022-06-16,EDGX Equities (K),298004063,141891777,324337623,764233463,9610653726.172700,8252687442.586597,13085042089.925704,30948383258.685001,2825603,843499,2531362,6200464
2022-06-16,LTSE (L),26418,65699,45904,138021,1538809.180000,11673422.490000,1380141.539100,14592373.209100,320,394,505,1219
2022-06-16,NYSE Chicago (M),29713985,17265218,18236273,65215476,1392543802.192800,2138752241.744700,3397449939.716498,6928745983.653998,70500,5367,50606,126473
2022-06-16,NYSE (N),1367295567,64091203,106476091,1537862861,58305232750.788485,4370634539.310699,4344980021.633601,67020847311.732785,5952363,317256,871439,7141058
2022-06-16,NYSE Arca (P),284343497,500692847,444883390,1229919734,10132492095.735498,31393902746.431422,19734084276.636998,61260479118.803918,3048589,2244868,4113654,9407111
2022-06-16,NASDAQ (Q),661094294,312741382,1380467544,2354303220,27983763053.427294,21869586605.989704,70737150629.370806,120590500288.787804,9063933,2210245,11467733,22741911
2022-06-16,Members Exchange (U),220188001,127854770,186983478,535026249,5543388107.716700,6925674743.432398,6333379633.724898,18802442484.873996,1896449,708063,1616327,4220839
2022-06-16,Investors Exchange (V),208716537,48435843,157639208,414791588,10116051192.056601,3464573955.955799,8180674355.135401,21761299503.147801,2590229,312519,2024145,4926893
2022-06-16,NASDAQ PSX (X),36394061,40671924,31311306,108377291,1063115778.235300,2160838711.088000,1435794871.305700,4659749360.629000,360811,198552,339621,898984
2022-06-16,BYX Equities (Y),77071422,56082687,57934640,191088749,1908814921.179900,3423084091.828299,1947214736.367100,7279113749.375299,872062,318131,662491,1852684
2022-06-16,BZX Equities (Z),293499228,217770151,248302752,759572131,10135948726.350202,15312676030.527803,12364338321.669300,37812963078.547305,3546287,1432723,2891295,7870305
2022-06-15,NYSE American (A),21292355,38246229,16269513,75808097,579108879.115800,1061550085.310100,659867733.359100,2300526697.785000,209055,140664,163758,513477
2022-06-15,NASDAQ BX (B),26019202,21448999,28147853,75616054,1101008808.296400,1451116371.709200,1578111375.499501,4130236555.505101,627046,169252,554620,1350918
2022-06-15,NYSE National (C),49541458,35078313,34965929,119585700,1096554239.624500,1554935085.626800,1045642640.549100,3697131965.800400,518708,222646,397589,1138943
2022-06-15,FINRA / Nasdaq TRF Chicago (DB),7443266,2925480,11782720,22151466,257741290.869000,160235849.389600,800488842.107900,1218465982.366500,35782,12404,58724,106910
2022-06-15,FINRA / NYSE TRF (DN),268871095,151436793,446165249,866473137,8138691648.542202,5863950752.282902,17365994476.284202,31368636877.109306,1303109,334085,1521214,3158408
2022-06-15,FINRA / Nasdaq TRF Carteret (DQ),1552703597,866940307,1840966679,4260610583,57005119807.113508,50947265975.621237,79207956148.993802,187160341931.728547,7695020,2487850,7394118,17576988
2022-06-15,MIAX Pearl (H),46928849,40046369,39152788,126128006,987427863.230300,2036615610.147000,1574512043.399900,4598555516.777200,427298,189788,376886,993972
2022-06-15,EDGA Equities (J),88833521,55626006,66023182,210482709,2875368893.688400,2866475341.282600,2737927208.775900,8479771443.746900,1200460,436924,919745,2557129
2022-06-15,EDGX Equities (K),300936895,150761441,303387164,755085500,9287250286.861998,8711580420.084504,13398379366.690699,31397210073.637201,2656628,868223,2375238,5900089
2022-06-15,LTSE (L),315779,241,45274,361294,7370123.350000,12317.640000,782152.387800,8164593.377800,466,4,472,942
2022-06-15,NYSE Chicago (M),13377869,13984108,18314280,45676257,1017721147.394000,1588721300.296000,2875658959.516299,5482101407.206299,110420,6157,94953,211530
2022-06-15,NYSE (N),1352213160,67376208,106218130,1525807498,56637194059.208505,4182922514.401199,4207741965.634400,65027858539.244104,5927935,331499,862166,7121600
2022-06-15,NYSE Arca (P),297560160,502976430,418759685,1219296275,9558428232.975700,30768500311.890508,19661255660.087996,59988184204.954204,2937038,2197480,4023959,9158477
2022-06-15,NASDAQ (Q),675429910,344568381,1368385096,2388383387,26978950276.180099,24396947841.008100,69549677025.454589,120925575142.642788,9029772,2608122,11337299,22975193
2022-06-15,Members Exchange (U),232418335,138367699,191815678,562601712,5411510781.406799,7151687533.723800,6061821726.601999,18625020041.732598,1897265,764785,1614611,4276661
2022-06-15,Investors Exchange (V),185925986,48322669,143659409,377908064,9276986186.188100,3733434615.971901,8187065567.095699,21197486369.255700,2420807,294884,1894611,4610302
2022-06-15,NASDAQ PSX (X),38519558,48707985,36604437,123831980,1054887286.153400,2650119939.346699,1742418137.595700,5447425363.095799,350267,251229,347540,949036
2022-06-15,BYX Equities (Y),76461018,48856731,52020814,177338563,1765305627.135800,3037487484.115300,1945942389.338200,6748735500.589300,787767,301704,632800,1722271
2022-06-15,BZX Equities (Z),295697590,246891593,245818445,788407628,9560155291.406401,18090655088.799500,13001674846.052496,40652485226.258397,3520853,1784865,2950976,8256694
2022-06-14,NYSE American (A),17873532,27437073,13156994,58467599,553740688.045900,838026581.983600,533753684.147600,1925520954.177100,200750,130781,145051,476582
2022-06-14,NASDAQ BX (B),26436750,20692330,26096957,73226037,1123429493.742000,1261171203.824600,1219722342.805100,3604323040.371700,638829,151810,505839,1296478
2022-06-14,NYSE National (C),46165407,33077590,31760479,111003476,1081137025.116900,1355466680.011000,902799837.216500,3339403542.344400,534337,188982,373137,1096456
2022-06-14,FINRA / Nasdaq TRF Chicago (DB),7978465,3532046,11314689,22825200,275838426.862400,192966436.195100,714286414.101100,1183091277.158600,38536,13715,53401,105652
2022-06-14,FINRA / NYSE TRF (DN),278332914,156147704,445467216,879947834,8472777633.246598,6109701219.640601,15142326095.713601,29724804948.600800,1413751,380068,1496044,3289863
2022-06-14,FINRA / Nasdaq TRF Carteret (DQ),1611906518,1019314575,1799060628,4430281721,61251479320.519331,57006725101.111855,75083461501.335635,193341665922.966821,8219278,2937502,7290344,18447124
2022-06-14,MIAX Pearl (H),37495643,35000121,34053701,106549465,936606771.275500,1708126688.496600,1435501618.578700,4080235078.350800,375812,161332,342208,879352
2022-06-14,EDGA Equities (J),81132603,46656375,64391426,192180404,2670952234.908900,2412640379.494300,2634169531.968900,7717762146.372100,1140641,338683,897815,2377139
2022-06-14,EDGX Equities (K),279664173,132754595,274867729,687286497,8897775903.104305,7362744225.974603,10673140888.766601,26933661017.845509,2576824,788947,2169029,5534800
2022-06-14,LTSE (L),87331,1758,48426,137515,3427894.800000,405438.670000,1918350.547900,5751684.017900,493,20,624,1137
2022-06-14,NYSE Chicago (M),24760512,22792459,11354683,58907654,949898269.424200,4536108064.860099,1440305473.133200,6926311807.417499,62267,6427,44572,113266
2022-06-14,NYSE (N),1118625190,57904548,87181413,1263711151,49608529046.774513,3823100911.129699,3491554684.827401,56923184642.731613,5482056,295869,749342,6527267
2022-06-14,NYSE Arca (P),270146431,445828264,372774069,1088748764,9223066729.470103,26813249370.741314,16327154885.820791,52363470986.032208,2778878,2004630,3644983,8428491
2022-06-14,NASDAQ (Q),591735167,273258900,1065082570,1930076637,24930917057.554611,19305087829.976509,55850567168.979484,100086572056.510604,8235114,2115074,10129996,20480184
2022-06-14,Members Exchange (U),210245591,108129228,159191164,477565983,5174459194.659500,5654294992.257800,5459832060.640599,16288586247.557899,1735871,635860,1389692,3761423
2022-06-14,Investors Exchange (V),175828406,45822804,131749061,353400271,9078046843.610598,3144604228.738500,7333076787.986900,19555727860.335998,2241957,280344,1715280,4237581
2022-06-14,NASDAQ PSX (X),26350174,36210701,24127946,86688821,738325811.787100,1852091548.631300,1199589153.491500,3790006513.909900,250475,184754,259367,694596
2022-06-14,BYX Equities (Y),75450579,47783203,52892181,176125963,1804204015.406300,2804382949.654400,1784851393.484599,6393438358.545299,813622,281572,618321,1713515
2022-06-14,BZX Equities (Z),273678969,202915252,215324388,691918609,9217595755.360100,15149380535.959800,10211139422.195202,34578115713.515102,3346222,1403708,2647258,7397188
2022-06-13,NYSE American (A),22217217,37531044,18281500,78029761,767205480.912700,1435145961.833999,843110837.989300,3045462280.735999,226437,166426,179203,572066
2022-06-13,NASDAQ BX (B),29037932,29577797,32675332,91291061,1193345810.085300,1933837325.890600,1765438780.078600,4892621916.054500,636739,220011,592492,1449242
2022-06-13,NYSE National (C),52997301,44130576,37573381,134701258,1239188152.911200,1818253002.057900,1190852400.604000,4248293555.573100,576177,248215,444910,1269302
2022-06-13,FINRA / Nasdaq TRF Chicago (DB),10104103,3998339,15302694,29405136,344823247.902800,254770255.363800,837836701.436400,1437430204.703000,47711,17501,76786,141998
2022-06-13,FINRA / NYSE TRF (DN),277551352,178452641,505650454,961654447,8890431062.053402,7432147217.219604,17388905540.244689,33711483819.517695,1641955,496546,1991731,4130232
2022-06-13,FINRA / Nasdaq TRF Carteret (DQ),1665514382,1421130536,2167383858,5254028776,64921616317.484687,92562129370.349864,94579389156.016947,252063134843.851498,9075635,3931164,9399821,22406620
2022-06-13,MIAX Pearl (H),53237893,44612291,39960742,137810926,1226113076.526800,2268700348.754300,1523368711.619500,5018182136.900600,469983,203346,399314,1072643
2022-06-13,EDGA Equities (J),91326101,61881009,74532152,227739262,3121691316.615800,3119664466.342502,3257856044.384201,9499211827.342503,1236081,414220,1014999,2665300
2022-06-13,EDGX Equities (K),313441216,166932489,348245848,828619553,9971979514.571401,9513021650.125401,14018623879.840301,33503625044.537103,2955637,989849,2748850,6694336
2022-06-13,LTSE (L),44778,22001,104680,171459,2875343.970000,2238309.550000,16157065.299700,21270718.819700,522,13,1242,1777
2022-06-13,NYSE Chicago (M),12924394,16461239,15623331,45008964,880242860.626600,2384794851.307500,2018425817.180701,5283463529.114801,82146,7698,59072,148916
2022-06-13,NYSE (N),1224788147,79474503,104514919,1408777569,55467180436.871516,5087412952.970999,4448971350.780000,65003564740.622515,6062688,375347,854176,7292211
2022-06-13,NYSE Arca (P),301209245,588415138,482253732,1371878115,10526393090.931201,36481054586.999221,22497077661.748896,69504525339.679318,3122381,2613887,4618814,10355082
2022-06-13,NASDAQ (Q),693657093,374752112,1366566584,2434975789,29034804476.958498,27210039334.218198,76343558923.737037,132588402734.913733,9220417,2715616,12293922,24229955
2022-06-13,Members Exchange (U),236645352,149759292,202121736,588526380,5821315872.573400,8644397319.264602,6947084072.527499,21412797264.365501,1894227,857342,1705582,4457151
2022-06-13,Investors Exchange (V),198662556,64562262,162180492,425405310,10395609856.137300,4849394518.020600,9502675638.297799,24747680012.455699,2483798,408605,2052750,4945153
2022-06-13,NASDAQ PSX (X),39467398,54042152,36204341,129713891,1050773739.598200,2793752477.951600,2071820937.576600,5916347155.126400,343349,269657,371744,984750
2022-06-13,BYX Equities (Y),89135427,67756683,62453936,219346046,2060911827.961700,3811791088.554199,2350568342.850400,8223271259.366299,862281,377410,696420,1936111
2022-06-13,BZX Equities (Z),324935606,263590040,265691316,854216962,10383678909.356598,18432818029.665602,13214123989.793501,42030620928.815701,3725857,1707380,3128905,8562142
2022-06-10,NYSE American (A),19505673,30063719,14443057,64012449,627470788.102400,1031891132.021800,686425309.319500,2345787229.443700,205139,130467,152146,487752
2022-06-10,NASDAQ BX (B),23530024,21917565,25859222,71306811,1038843471.628900,1527872876.678200,1578697470.630199,4145413818.937299,592931,157689,531702,1282322
2022-06-10,NYSE National (C),44241392,31341585,29586903,105169880,970096409.210000,1299824728.540000,954101909.879800,3224023047.629800,494388,179899,365232,1039519
2022-06-10,FINRA / Nasdaq TRF Chicago (DB),9105847,3256697,11935454,24297998,292151392.048000,182206024.233700,865930253.146000,1340287669.427700,37764,14969,63970,116703
2022-06-10,FINRA / NYSE TRF (DN),248890309,139807014,471758222,860455545,7869253942.992406,5745874284.341997,16403040822.610598,30018169049.945001,1366697,385030,1746571,3498298
2022-06-10,FINRA / Nasdaq TRF Carteret (DQ),1458096561,963744430,1906577527,4328418518,55894384233.620828,62626776932.699197,80151868539.006346,198673029705.326371,7511505,3076812,7923352,18511669
2022-06-10,MIAX Pearl (H),55969440,34004489,34682074,124656003,1074505417.479100,1926627658.364100,1466744789.681400,4467877865.524600,400951,162533,356583,920067
2022-06-10,EDGA Equities (J),74883515,44375852,58659699,177919066,2607782305.466800,2281526051.971700,2591589713.389700,7480898070.828200,1059831,300075,841525,2201431
2022-06-10,EDGX Equities (K),267770660,136367600,302433229,706571489,8790842860.373898,8089280584.377604,13062998985.130192,29943122429.881694,2499712,760221,2398598,5658531
2022-06-10,LTSE (L),45099,2636,91933,139668,2924993.480000,299802.510000,4791188.910200,8015984.900200,458,18,665,1141
2022-06-10,NYSE Chicago (M),10345811,12897813,14402055,37645679,797244485.439200,2230043807.757200,2217090737.468800,5244379030.665200,70649,6887,50115,127651
2022-06-10,NYSE (N),1065561839,55384063,85729503,1206675405,48340746482.802801,4062289432.597799,3677924559.814200,56080960475.214800,5241337,270352,730530,6242219
2022-06-10,NYSE Arca (P),266722424,444157255,419248680,1130128359,9398878372.103501,29527682274.690504,20679403430.627208,59605964077.421213,2778964,2015090,4056971,8851025
2022-06-10,NASDAQ (Q),597308880,280938462,1171611507,2049858849,25575103057.223401,21184583073.109900,65874136657.032294,112633822787.365595,8050346,2035332,10751066,20836744
2022-06-10,Members Exchange (U),205035514,108412121,169915314,483362949,4990515594.185899,6045095782.566199,5793588285.213500,16829199661.965598,1628488,620631,1454614,3703733
2022-06-10,Investors Exchange (V),157053045,40137568,124137199,321327812,8302679573.525401,3092462991.760300,7713356885.893799,19108499451.179500,2012680,263577,1630157,3906414
2022-06-10,NASDAQ PSX (X),35501173,41414464,30215231,107130868,809080304.332700,2300079632.690800,1516544453.763500,4625704390.787000,268747,211548,308073,788368
2022-06-10,BYX Equities (Y),78737869,49150719,52628039,180516627,1763772477.416900,3260687317.298100,2066689266.114600,7091149060.829600,749279,290791,609303,1649373
2022-06-10,BZX Equities (Z),271338613,199164512,228106599,698609724,9142948249.427802,15281363058.342091,12720570572.540199,37144881880.310092,3186615,1302693,2730072,7219380
2022-06-09,NYSE American (A),15706368,24295447,12234006,52235821,503666361.495100,710968559.343900,486436959.860700,1701071880.699700,168701,102422,131789,402912
2022-06-09,NASDAQ BX (B),19052289,13374046,23177456,55603791,881700739.990100,940628966.175300,1212032610.976399,3034362317.141799,470276,104361,445974,1020611
2022-06-09,NYSE National (C),34921484,24214665,27578072,86714221,828497467.258400,1076305440.393400,779501379.480400,2684304287.132200,388384,133631,312052,834067
2022-06-09,FINRA / Nasdaq TRF Chicago (DB),7673328,2365624,13227755,23266707,306375689.064600,128348496.883100,792464455.884000,1227188641.831700,35205,10060,57366,102631
2022-06-09,FINRA / NYSE TRF (DN),221948982,122771289,611438573,956158844,7794720141.235815,4564546501.197703,15385802852.820299,27745069495.253817,1187165,290940,1554168,3032273
2022-06-09,FINRA / Nasdaq TRF Carteret (DQ),1296462787,778687125,2121391350,4196541262,53276880533.594500,45131062469.895496,73323973678.309332,171731916681.799328,6475385,2184542,6989883,15649810
2022-06-09,MIAX Pearl (H),40561202,27078819,32894458,100534479,907134847.670700,1359128726.814100,1213334727.922100,3479598302.406900,354617,118342,335606,808565
2022-06-09,EDGA Equities (J),61921672,30528757,62504694,154955123,2231318916.209400,1655571002.853600,2089282139.725600,5976172058.788600,943484,225041,774745,1943270
2022-06-09,EDGX Equities (K),235178765,100329661,330315395,665823821,8509069046.756906,5331704398.929399,11149028448.997197,24989801894.683502,2237153,523682,2165975,4926810
2022-06-09,LTSE (L),53474,643,66970,121087,3088435.920000,129090.710000,1978624.462000,5196151.092000,574,8,635,1217
2022-06-09,NYSE Chicago (M),8218298,8815191,9972073,27005562,562034093.522400,1472119206.383000,1511052069.301400,3545205369.206800,50971,4651,43793,99415
2022-06-09,NYSE (N),895476219,36784739,76933812,1009194770,43532980458.460108,2627610658.167200,2892564577.610200,49053155694.237508,4496616,185214,639269,5321099
2022-06-09,NYSE Arca (P),217819543,335489009,424475960,977784512,8242709580.521900,21449418578.099097,16613363171.490999,46305491330.111996,2276347,1394114,3456886,7127347
2022-06-09,NASDAQ (Q),474501019,186812757,1084195011,1745508787,21211729952.641596,13473599420.277806,54606627779.351199,89291957152.270601,6672380,1359996,9440339,17472715
2022-06-09,Members Exchange (U),166308936,75978972,171429264,413717172,4395121139.094200,4291569618.042200,4973488405.361100,13660179162.497500,1409651,450824,1359214,3219689
2022-06-09,Investors Exchange (V),138409165,30313304,116523089,285245558,7496463060.822298,2338357520.570900,6648085189.725200,16482905771.118398,1878267,200658,1555675,3634600
2022-06-09,NASDAQ PSX (X),26499863,31052604,23705143,81257610,666539903.292200,1608127390.780800,1029335248.155000,3304002542.228000,209125,137749,237041,583915
2022-06-09,BYX Equities (Y),63258722,36334922,53753092,153346736,1565348796.748800,2351608547.219301,1689997758.466300,5606955102.434401,681309,204864,576606,1462779
2022-06-09,BZX Equities (Z),210201212,134664857,212644966,557511035,7281984747.703000,9724753828.619195,9287217469.804197,26293956046.126392,2601422,897957,2313522,5812901
2022-06-08,NYSE American (A),14365512,25309814,10460846,50136172,471528410.989200,604686533.376400,417523302.541500,1493738246.907100,159588,104250,120114,383952
2022-06-08,NASDAQ BX (B),19957646,12425996,19923193,52306835,903187949.566600,833571287.479700,1033977829.792000,2770737066.838300,528746,113879,447095,1089720
2022-06-08,NYSE National (C),34886337,22196078,25065807,82148222,812875295.320700,927571146.523600,707640244.220500,2448086686.064800,426326,134340,324860,885526
2022-06-08,FINRA / Nasdaq TRF Chicago (DB),9459282,2919095,14401666,26780043,348164080.146000,158284869.494600,740974586.505300,1247423536.145900,39819,11151,60888,111858
2022-06-08,FINRA / NYSE TRF (DN),247254046,141847515,495693355,884794916,8912729865.474498,4449093111.679501,15139553791.965186,28501376769.119185,1273772,308489,1543593,3125854
2022-06-08,FINRA / Nasdaq TRF Carteret (DQ),1357565901,717364115,1838878002,3913808018,55042167498.944618,36184910126.413693,67149162179.516708,158376239804.875019,6679562,1919768,6868743,15468073
2022-06-08,MIAX Pearl (H),45639553,21833851,32454018,99927422,878956259.969500,1059977696.671300,1166044847.719700,3104978804.360500,342621,109394,325209,777224
2022-06-08,EDGA Equities (J),60494310,27988682,49345548,137828540,2184990319.697400,1448431528.939500,1923803689.052900,5557225537.689800,947969,210870,750013,1908852
2022-06-08,EDGX Equities (K),242861233,96100122,288546959,627508314,8903426851.281098,4675462052.213301,10420422363.478498,23999311266.972897,2202708,501519,2080446,4784673
2022-06-08,LTSE (L),94557,8047,174015,276619,5393388.290000,885692.960000,5113986.361600,11393067.611600,690,38,786,1514
2022-06-08,NYSE Chicago (M),9865761,14751991,8212536,32830288,601625690.016200,1359502191.380800,1165086045.618400,3126213927.015400,44230,6128,38668,89026
2022-06-08,NYSE (N),848845179,32775025,72765799,954386003,40384240216.462600,2257463658.179900,2717304650.413299,45359008525.055799,4161791,172706,636657,4971154
2022-06-08,NYSE Arca (P),204606510,291727801,359629268,855963579,7800571618.969104,16883714436.548686,14016035697.512906,38700321753.030696,2192892,1304557,3364832,6862281
2022-06-08,NASDAQ (Q),466672264,168960430,976879479,1612512173,20516531937.500800,11527828964.757501,48482517320.387901,80526878222.646202,6510082,1264230,8811579,16585891
2022-06-08,Members Exchange (U),168735831,68936119,157145140,394817090,4318013083.525200,3623888977.886000,4606047123.578900,12547949184.990100,1398797,422448,1307713,3128958
2022-06-08,Investors Exchange (V),134791443,28222320,103922824,266936587,7283551745.962701,2107157316.107700,6039814881.697499,15430523943.767900,1890308,198080,1478629,3567017
2022-06-08,NASDAQ PSX (X),26922875,27346475,22645133,76914483,655828021.641900,1316713714.481300,956115107.090100,2928656843.213300,211375,115463,232379,559217
2022-06-08,BYX Equities (Y),59334874,32143257,45295358,136773489,1429910192.544600,2231592974.287299,1424648017.583600,5086151184.415499,674092,211736,541115,1426943
2022-06-08,BZX Equities (Z),207118182,120296225,187547566,514961973,7211325840.924900,9019261897.467197,8075992806.165402,24306580544.557499,2595573,875772,2192085,5663430
2022-06-07,NYSE American (A),14586351,25478136,11579933,51644420,475236469.262900,639040112.715800,438606150.604200,1552882732.582900,169696,113571,134035,417302
2022-06-07,NASDAQ BX (B),20765581,12342290,21826240,54934111,904407446.563500,790746537.728200,1153258380.766400,2848412365.058100,489679,95269,453423,1038371
2022-06-07,NYSE National (C),34861384,21446054,26444585,82752023,886667004.064300,962911444.154300,868470802.310700,2718049250.529300,440741,127246,361861,929848
2022-06-07,FINRA / Nasdaq TRF Chicago (DB),7411518,2758034,10922861,21092413,290463448.459700,141348408.439500,635107761.839800,1066919618.739000,32780,10485,51534,94799
2022-06-07,FINRA / NYSE TRF (DN),217773082,125305568,411169960,754248610,8034145816.968298,4257519869.303500,14060253809.008306,26351919495.280104,1191131,294801,1481921,2967853
2022-06-07,FINRA / Nasdaq TRF Carteret (DQ),1432082101,704768282,1703579977,3840430360,61478525689.699015,36042645167.255774,69272885525.335068,166794056382.289857,6608612,1952063,6821544,15382219
2022-06-07,MIAX Pearl (H),42266429,22471994,31989602,96728025,892266088.026400,1187038265.725300,1230508085.205500,3309812438.957200,341352,105987,335379,782718
2022-06-07,EDGA Equities (J),60183696,27846695,48620450,136650841,2225599072.504000,1498636998.003800,2021485418.176200,5745721488.684000,931632,206476,748850,1886958
2022-06-07,EDGX Equities (K),225176506,95158404,253881589,574216499,8392166504.719500,4650058924.917699,10087395877.678999,23129621307.316198,2072152,487953,1959728,4519833
2022-06-07,LTSE (L),87530,9,69576,157115,6614935.480000,1112.400000,2933038.490200,9549086.370200,934,1,890,1825
2022-06-07,NYSE Chicago (M),9288724,18051604,10325415,37665743,685282462.276500,1286094653.725600,1351555098.549400,3322932214.551500,44269,4441,40662,89372
2022-06-07,NYSE (N),945199797,32997808,71180056,1049377661,46028124257.706696,2147059612.553000,2815681760.475900,50990865630.735596,3965456,167501,625414,4758371
2022-06-07,NYSE Arca (P),193484986,265909827,329228379,788623192,7426917689.717101,16069637658.906092,14387360319.219898,37883915667.843091,2050740,1202085,3190138,6442963
2022-06-07,NASDAQ (Q),448699197,174119306,974976309,1597794812,19976665977.964099,11942228059.305204,51612333738.930492,83531227776.199795,6168461,1233680,8298675,15700816
2022-06-07,Members Exchange (U),168088730,69623254,148118428,385830412,4418550477.980600,3729507480.864000,4511370359.367200,12659428318.211800,1421664,417432,1302068,3141164
2022-06-07,Investors Exchange (V),141136246,29087546,108614891,278838683,7686880971.140202,2027295901.433700,6187197895.578700,15901374768.152602,1861636,179238,1510369,3551243
2022-06-07,NASDAQ PSX (X),24796803,27634725,23094549,75526077,653950838.828400,1242085913.238300,1044517090.347200,2940553842.413900,209378,119859,230227,559464
2022-06-07,BYX Equities (Y),60821064,32807617,45764452,139393133,1523004359.620100,2014900998.480400,1646621476.227900,5184526834.328400,665079,191589,556016,1412684
2022-06-07,BZX Equities (Z),201500293,119268607,179855947,500624847,7270309348.148899,8648936325.457198,8367704948.501501,24286950622.107598,2526543,794762,2162162,5483467
2022-06-06,NYSE American (A),15305678,20379789,12782356,48467823,465771800.515600,559156477.060500,469451469.259100,1494379746.835200,185042,97288,149462,431792
2022-06-06,NASDAQ BX (B),21063937,12722349,22784794,56571080,857529079.328100,858935451.078400,1186093119.100400,2902557649.506900,506673,108782,458445,1073900
2022-06-06,NYSE National (C),38502576,22169771,30492178,91164525,837594221.685600,964758951.712300,848717346.255700,2651070519.653600,441415,138422,363061,942898
2022-06-06,FINRA / Nasdaq TRF Chicago (DB),8910821,2679132,12420528,24010481,241281658.848000,130903717.570900,800743499.548900,1172928875.967800,33975,10002,60872,104849
2022-06-06,FINRA / NYSE TRF (DN),226573981,107754988,430718171,765047140,6745156302.914702,4171336258.081302,17485995539.307907,28402488100.303911,1236791,277836,1697262,3211889
2022-06-06,FINRA / Nasdaq TRF Carteret (DQ),1436807370,662397934,1767242688,3866447992,53331567667.800988,35333483499.046406,77239922086.063333,165904973252.910727,6688474,1968592,7719025,16376091
2022-06-06,MIAX Pearl (H),55384201,23934653,35629244,114948098,988438866.453900,1127997432.507700,1349502776.672500,3465939075.634100,379848,110383,383038,873269
2022-06-06,EDGA Equities (J),61346781,27101727,53979402,142427910,2061361763.737200,1478747857.848099,2301327768.576401,5841437390.161700,972342,207068,832983,2012393
2022-06-06,EDGX Equities (K),251193651,85838339,276594498,613626488,7624284785.719601,4584276644.751800,11953032173.726405,24161593604.197806,2225178,477072,2234566,4936816
2022-06-06,LTSE (L),54524,1401,23062,78987,2935332.750000,44006.100000,839254.539300,3818593.389300,590,4,284,878
2022-06-06,NYSE Chicago (M),5763310,9935958,12130512,27829780,509706596.202000,1020976134.234000,1783892232.840700,3314574963.276700,51648,4872,52067,108587
2022-06-06,NYSE (N),892567423,30296160,81300138,1004163721,38559935606.528000,2061409491.785399,3127782456.545200,43749127554.858599,4242146,157487,712255,5111888
2022-06-06,NYSE Arca (P),214719772,264105420,352040348,830865540,7288954660.172597,16333803111.204606,16578261749.047897,40201019520.425100,2233561,1260173,3565165,7058899
2022-06-06,NASDAQ (Q),489778639,169247528,987260916,1646287083,19720289900.063799,12628828819.121400,50549197831.658142,82898316550.843341,6641235,1290463,9325838,17257536
2022-06-06,Members Exchange (U),169632156,66618850,162067467,398318473,4049985812.348700,3653808859.056201,5046327882.929101,12750122554.334002,1435210,421889,1383201,3240300
2022-06-06,Investors Exchange (V),146641669,26314526,126255218,299211413,7065027256.156902,2025987537.316300,6429827471.962601,15520842265.435803,1946743,170088,1680106,3796937
2022-06-06,NASDAQ PSX (X),26877280,27319383,28733810,82930473,634679194.550800,1375409482.446800,1223164354.335700,3233253031.333300,221951,124073,271305,617329
2022-06-06,BYX Equities (Y),62389977,29506731,47591794,139488502,1369558047.611300,1825360557.479800,1620787698.773700,4815706303.864800,685535,178951,593197,1457683
2022-06-06,BZX Equities (Z),209194235,115352952,206966166,531513353,7029258308.954300,7587600637.835097,9967921351.428002,24584780298.217399,2767254,770268,2558460,6095982
2022-06-03,NYSE American (A),14863073,20702607,12415819,47981499,490805704.109300,725501879.157400,559936852.247500,1776244435.514200,176102,91230,140576,407908
2022-06-03,NASDAQ BX (B),17700136,12108656,19075940,48884732,776625068.094400,984385723.504300,1271957364.062900,3032968155.661600,469903,111221,435281,1016405
2022-06-03,NYSE National (C),35376412,21424041,26874455,83674908,831381983.286200,962455897.025300,880232935.306400,2674070815.617900,450982,136060,362728,949770
2022-06-03,FINRA / Nasdaq TRF Chicago (DB),5729710,2372144,10672211,18774065,230694224.809300,127972388.448300,926004065.756600,1284670679.014200,27325,9184,56713,93222
2022-06-03,FINRA / NYSE TRF (DN),201671967,119024686,380539445,701236098,6769363828.175300,4559497753.152198,16923075409.067080,28251936990.394578,1134269,286034,1502708,2923011
2022-06-03,FINRA / Nasdaq TRF Carteret (DQ),1178259226,638661193,1552054320,3368974739,46839351038.168926,36326844726.158584,77816837813.160560,160983033577.488070,6319274,1902424,6772397,14994095
2022-06-03,MIAX Pearl (H),52024831,25329887,30746032,108100750,1029283791.451900,1188060604.156500,1458755782.343500,3676100177.951900,346684,112518,334870,794072
2022-06-03,EDGA Equities (J),54337133,26405757,45496713,126239603,1934995322.047900,1517575023.645100,2163483075.463500,5616053421.156500,873163,199458,740114,1812735
2022-06-03,EDGX Equities (K),207711538,88479955,243396560,539588053,7191816835.857401,4887454031.327301,12422710599.368002,24501981466.552704,2009446,491838,2040400,4541684
2022-06-03,LTSE (L),360892,0,25179,386071,6046004.200000,0.000000,774977.310000,6820981.510000,606,0,347,953
2022-06-03,NYSE Chicago (M),10823511,10574909,10397330,31795750,739804855.654000,1085567363.008500,1526469967.972400,3351842186.634900,52058,4409,44582,101049
2022-06-03,NYSE (N),786792877,31310654,69179554,887283085,37631083538.823201,2190280184.844600,3090326372.451000,42911690096.118801,3977855,160604,622330,4760789
2022-06-03,NYSE Arca (P),186154051,271319141,310504764,767977956,7106241622.043399,17774752270.073698,17758830523.074590,42639824415.191687,2080271,1290561,3265073,6635905
2022-06-03,NASDAQ (Q),423041593,170617962,921959176,1515618731,19227667610.903102,13545244802.212602,57592045791.288972,90364958204.404676,6172135,1357937,8789983,16320055
2022-06-03,Members Exchange (U),146091927,66870346,139343384,352305657,3607569321.819300,3765913624.909201,4899575986.477700,12273058933.206201,1295259,426062,1252212,2973533
2022-06-03,Investors Exchange (V),123705104,24744281,101446996,249896381,7135053449.180900,2038065655.849900,6827460247.679700,16000579352.710500,1798809,173826,1503817,3476452
2022-06-03,NASDAQ PSX (X),22344407,26628490,23663604,72636501,577922961.922900,1437147615.823900,1167644793.217600,3182715370.964400,192994,131427,241177,565598
2022-06-03,BYX Equities (Y),52941973,27377490,41642053,121961516,1288985310.388300,1989898292.878900,1785038337.611599,5063921940.878799,631150,177716,547912,1356778
2022-06-03,BZX Equities (Z),191183008,119607897,190610899,501401804,7073581007.689202,8339379870.806994,11271935150.841802,26684896029.337998,2618356,830012,2409892,5858260
2022-06-02,NYSE American (A),18246423,23910471,14024766,56181660,632331403.450200,756083178.436500,608655685.367100,1997070267.253800,217038,108120,160119,485277
2022-06-02,NASDAQ BX (B),22044845,14492725,22320005,58857575,1000326953.312000,1225363484.553500,1467762614.776000,3693453052.641500,585878,117162,518508,1221548
2022-06-02,NYSE National (C),40240331,27527043,29003985,96771359,943696212.323900,1205260108.307900,867308722.823200,3016265043.455000,498447,170918,377186,1046551
2022-06-02,FINRA / Nasdaq TRF Chicago (DB),7872489,3095699,11051847,22020035,290286332.737300,138399123.034400,983545067.078500,1412230522.850200,36654,9775,58007,104436
2022-06-02,FINRA / NYSE TRF (DN),251892067,127377573,410575404,789845044,8726331820.884805,5074756693.590802,18855508311.092798,32656596825.568405,1331497,306610,1548769,3186876
2022-06-02,FINRA / Nasdaq TRF Carteret (DQ),1380784860,743626551,1619185758,3743597169,54583991272.544411,42157206188.368598,81841547810.053762,178582745270.966771,6725783,2152459,6696984,15575226
2022-06-02,MIAX Pearl (H),57584199,27096764,31402729,116083692,1117257157.548800,1272447299.907400,1489596666.021300,3879301123.477500,378147,117552,334597,830296
2022-06-02,EDGA Equities (J),66961612,31789365,51248063,149999040,2438837767.406200,1825662856.726300,2385670636.111701,6650171260.244201,1084665,235086,857664,2177415
2022-06-02,EDGX Equities (K),257860353,97976595,261102157,616939105,8784474802.628096,5332929838.851900,12829351061.850496,26946755703.330492,2312272,533383,2115157,4960812
2022-06-02,LTSE (L),52699,8,31944,84651,2573421.330000,420.400000,7892557.044400,10466398.774400,532,2,367,901
2022-06-02,NYSE Chicago (M),14529636,11881124,15098867,41509627,779526445.878800,1683929030.034500,1557222565.835900,4020678041.749200,56316,3562,45504,105382
2022-06-02,NYSE (N),908173712,38757856,74901988,1021833556,43245104505.436803,2668393639.971800,3369610951.613999,49283109097.022602,4519321,190619,689675,5399615
2022-06-02,NYSE Arca (P),225083133,307202660,357813182,890098975,8490583356.518904,19700418463.066390,18944673453.709901,47135675273.295195,2447467,1412198,3567475,7427140
2022-06-02,NASDAQ (Q),518000376,204297033,1004064740,1726362149,23422011930.545889,15804987962.910101,63104527246.340794,102331527139.796784,7171137,1536706,9618921,18326764
2022-06-02,Members Exchange (U),173372198,78018345,149400517,400791060,4415172623.880400,4332237716.008599,5397973126.194702,14145383466.083701,1525398,460324,1355950,3341672
2022-06-02,Investors Exchange (V),152044593,31145991,120792712,303983296,8558778337.610699,2437538829.855100,8715297627.660300,19711614795.126099,2073388,210614,1714125,3998127
2022-06-02,NASDAQ PSX (X),27097169,31680043,27038341,85815553,720979695.841100,1744750820.599801,1233101085.546500,3698831601.987401,235527,149087,257392,642006
2022-06-02,BYX Equities (Y),62661065,33310031,46399623,142370719,1600560471.225000,2307238683.962900,1922425712.354000,5830224867.541900,764244,207198,613136,1584578
2022-06-02,BZX Equities (Z),221295344,138684529,200391551,560371424,7901234374.090599,9702802269.086702,11929088189.602712,29533124832.780013,2816903,941221,2488122,6246246
2022-06-01,NYSE American (A),17637019,24385702,14756291,56779012,649685929.109400,795158114.994400,554421610.350500,1999265654.454300,206785,109229,155677,471691
2022-06-01,NASDAQ BX (B),23874929,15362411,24440309,63677649,1106531948.303600,1264502954.510100,1385570594.474700,3756605497.288400,567414,112453,503511,1183378
2022-06-01,NYSE National (C),41379464,28762757,29151153,99293374,1009872882.032700,1247133497.591000,879724235.965200,3136730615.588900,491143,177570,372902,1041615
2022-06-01,FINRA / Nasdaq TRF Chicago (DB),7337543,3213288,12870213,23421044,324849398.108400,160306831.516200,938953212.949400,1424109442.574000,37909,11221,58260,107390
2022-06-01,FINRA / NYSE TRF (DN),253300189,145297386,440923569,839521144,9098665120.104400,6134662842.356899,18140140505.209784,33373468467.671083,1410444,331087,1576198,3317729
2022-06-01,FINRA / Nasdaq TRF Carteret (DQ),1377530091,869382544,1768763128,4015675763,58284025159.330184,51932044356.991630,81099160054.173840,191315229570.495654,7177890,2316714,7106720,16601324
2022-06-01,MIAX Pearl (H),50509324,31684307,36355362,118548993,1097887796.929600,1531616002.182000,1469415002.033200,4098918801.144800,428165,141576,388360,958101
2022-06-01,EDGA Equities (J),69722710,33594069,53817461,157134240,2628200985.648900,1951430995.292000,2431909373.334400,7011541354.275300,1087821,256470,847537,2191828
2022-06-01,EDGX Equities (K),254214482,108686222,277395561,640296265,9142560115.526104,6221465159.785302,12612079268.188899,27976104543.500305,2362583,584313,2163683,5110579
2022-06-01,LTSE (L),99102,10000,32703,141805,4330820.570000,727200.000000,1167399.783800,6225420.353800,710,1,404,1115
2022-06-01,NYSE Chicago (M),13201996,17193562,10040574,40436132,753321407.583900,1691179993.259901,1581369301.778900,4025870702.622701,62307,4653,49669,116629
2022-06-01,NYSE (N),997249813,48940123,83733785,1129923721,48221761114.341999,3269695819.337900,3507958292.321899,54999415226.001798,4828803,223749,724210,5776762
2022-06-01,NYSE Arca (P),230671977,341547619,363320863,935540459,8883841793.560001,22438982614.345302,17338878349.312500,48661702757.217803,2494648,1543497,3486766,7524911
2022-06-01,NASDAQ (Q),531269695,227284160,1040581395,1799135250,24358313577.313196,18308396748.919510,59770487373.862622,102437197700.095328,7762498,1741678,10014259,19518435
2022-06-01,Members Exchange (U),181876172,88663738,162423853,432963763,4711990324.424999,4895459868.861902,5173612002.759900,14781062196.046801,1532619,530076,1374874,3437569
2022-06-01,Investors Exchange (V),149859806,35939931,114210059,300009796,8349213761.071099,2767112268.112000,7192384913.374601,18308710942.557700,2131258,239685,1667011,4037954
2022-06-01,NASDAQ PSX (X),27945113,36957694,31741676,96644483,762620312.418100,1971671200.702800,1369463760.899300,4103755274.020200,244196,180192,269006,693394
2022-06-01,BYX Equities (Y),70189227,35874868,49505832,155569927,1735708614.057300,2365692921.788500,1794976967.155500,5896378503.001300,785663,219500,612733,1617896
2022-06-01,BZX Equities (Z),233939068,153071155,205840454,592850677,8435115684.951099,10248154665.467993,11254199668.438900,29937470018.857992,2921483,1041521,2501508,6464512
2022-05-31,NYSE American (A),19985423,54907017,14362289,89254729,678327614.023900,1162253915.269800,650262197.538600,2490843726.832300,216041,137393,160045,513479
2022-05-31,NASDAQ BX (B),27457983,18465370,25425944,71349297,1235723752.552700,1424244403.417000,1588680345.874500,4248648501.844200,572349,166285,506022,1244656
2022-05-31,NYSE National (C),50866918,35286305,31982738,118135961,1243280614.531800,1592249499.545500,1029571635.864700,3865101749.942000,550068,218669,382277,1151014
2022-05-31,FINRA / Nasdaq TRF Chicago (DB),9216501,3775225,14420214,27411940,359410257.278000,178479119.264700,980523001.657800,1518412378.200500,42576,13580,64499,120655
2022-05-31,FINRA / NYSE TRF (DN),273897383,163855292,446221129,883973804,9481389465.107491,5474518876.419401,18799861129.316287,33755769470.843179,1507013,384403,1684926,3576342
2022-05-31,FINRA / Nasdaq TRF Carteret (DQ),2053073738,1056930764,2169508985,5279513487,98148799421.656015,60668167144.961297,111325945799.244407,270142912365.861719,7770626,2701900,7308004,17780530
2022-05-31,MIAX Pearl (H),43730825,34793049,34229944,112753818,1088030323.556200,1687492007.022700,1482699918.534300,4258222249.113200,430179,158190,378084,966453
2022-05-31,EDGA Equities (J),71688624,39550509,50931238,162170371,2760928780.559200,2316544683.581500,2413799610.913900,7491273075.054600,1084809,291940,792404,2169153
2022-05-31,EDGX Equities (K),292363756,131657812,278447175,702468743,10350296493.449203,6850288883.228003,13236713796.981799,30437299173.659005,2612385,731135,2185736,5529256
2022-05-31,LTSE (L),55851,1605,83331,140787,3585949.950000,32047.650000,1396231.474000,5014229.074000,707,17,875,1599
2022-05-31,NYSE Chicago (M),30351380,11289359,14441800,56082539,1453821579.384000,1121215815.453300,1722173902.361400,4297211297.198700,65261,5896,52030,123187
2022-05-31,NYSE (N),2287322350,55055436,88128203,2430505989,122873828584.349408,3906085589.588900,3907955577.783999,130687869751.722307,5397809,268983,758599,6425391
2022-05-31,NYSE Arca (P),263758530,418337515,372022757,1054118802,10381659307.469305,26267902756.466699,19475996016.993496,56125558080.929500,2757731,1847430,3648481,8253642
2022-05-31,NASDAQ (Q),613436808,261425551,1876571389,2751433748,28337384054.301803,20075632383.487291,104180095187.626191,152593111625.415285,8027552,1883469,10150875,20061896
2022-05-31,Members Exchange (U),214413382,106072374,178275618,498761374,5594667084.003800,5480453661.780600,5555845943.078899,16630966688.863299,1711875,587268,1420910,3720053
2022-05-31,Investors Exchange (V),175516143,46424049,131079446,353019638,10065461229.265399,3382974900.110399,8920906220.683500,22369342350.059298,2259843,277919,1757325,4295087
2022-05-31,NASDAQ PSX (X),37426606,42174755,37512007,117113368,972216388.170200,2213129116.711400,1549022714.060600,4734368218.942200,300987,190501,299693,791181
2022-05-31,BYX Equities (Y),78695504,44062129,54986519,177744152,2154895654.168900,2793744569.203700,2246423760.111600,7195063983.484200,851968,272935,629861,1754764
2022-05-31,BZX Equities (Z),279384761,175819955,226872888,682077604,10874004177.492903,12448758542.064995,12905436708.092695,36228199427.650593,3427934,1181449,2704762,7314145
2022-05-27,NYSE American (A),15121456,21629323,12108099,48858878,527009652.341000,863340171.987300,588694236.895100,1979044061.223400,169403,99688,139819,408910
2022-05-27,NASDAQ BX (B),20106548,12900553,20920788,53927889,929926440.746800,1032740396.950400,1159686501.949500,3122353339.646700,472357,108808,416432,997597
2022-05-27,NYSE National (C),35081833,23231508,28239327,86552668,892900738.264700,1057845961.852500,892258463.749700,2843005163.866900,409091,143604,320630,873325
2022-05-27,FINRA / Nasdaq TRF Chicago (DB),8539042,2769246,13338383,24646671,278330152.916500,141788751.564900,840432936.516200,1260551840.997600,38238,10243,63779,112260
2022-05-27,FINRA / NYSE TRF (DN),251266171,126710795,453713750,831690716,8341717467.913101,4964760465.596596,18037045852.149422,31343523785.659119,1349726,304611,1653457,3307794
2022-05-27,FINRA / Nasdaq TRF Carteret (DQ),1406340256,765649254,1856355020,4028344530,55794655201.363394,43901529087.991479,84702977156.298626,184399161445.653499,6938888,2031920,7266948,16237756
2022-05-27,MIAX Pearl (H),44032409,25624230,31414123,101070762,1032170319.871500,1266618481.736500,1514655734.637300,3813444536.245300,387123,121141,358240,866504
2022-05-27,EDGA Equities (J),56893448,27114133,50663519,134671100,2348564240.297000,1523150585.155800,2296846432.977500,6168561258.430300,921442,206137,750023,1877602
2022-05-27,EDGX Equities (K),259332373,95458402,285143424,639934199,8947907508.540701,5337861205.313302,13059322170.372902,27345090884.226905,2255857,510708,2149442,4916007
2022-05-27,LTSE (L),37746,201,35783,73730,2282908.170000,10078.700000,977324.276900,3270311.146900,492,2,453,947
2022-05-27,NYSE Chicago (M),18932484,12553726,15249654,46735864,844136120.623500,1838295636.833700,2355453031.133201,5037884788.590401,36505,3079,33015,72599
2022-05-27,NYSE (N),923267829,38738865,81275964,1043282658,47869968050.321493,2675289422.378801,3508373831.281799,54053631303.982093,4256890,180388,716258,5153536
2022-05-27,NYSE Arca (P),214206465,285044886,358604424,857855775,8267002828.772602,19329844098.733299,18205828732.276000,45802675659.781901,2304886,1349079,3460947,7114912
2022-05-27,NASDAQ (Q),502412878,183996397,1027990183,1714399458,23286188624.468899,15156334703.031803,63967000186.372171,102409523513.872873,6892008,1346983,9147935,17386926
2022-05-27,Members Exchange (U),170021993,72561661,152617587,395201241,4575885212.557800,4032403215.247502,5112067775.293499,13720356203.098801,1445347,410653,1300011,3156011
2022-05-27,Investors Exchange (V),142182663,29177036,122239663,293599362,8179167704.792000,2397353335.810900,8123654853.317396,18700175893.920296,1944600,196137,1614239,3754976
2022-05-27,NASDAQ PSX (X),26561615,30610248,27351752,84523615,724692401.521100,1726934996.542300,1301181495.275800,3752808893.339200,235959,143074,264300,643333
2022-05-27,BYX Equities (Y),57688732,32284718,48772465,138745915,1578222302.386400,2107635236.383900,1855677241.862400,5541534780.632700,682164,192140,578396,1452700
2022-05-27,BZX Equities (Z),223596912,119858598,207874095,551329605,8569069830.377902,8834510765.457002,11990821474.990598,29394402070.825502,2809038,824217,2471632,6104887
2022-05-26,NYSE American (A),18406097,21668600,12115004,52189701,611545701.036700,899702055.922900,547680807.416600,2058928564.376200,187162,104908,143442,435512
2022-05-26,NASDAQ BX (B),21337291,16617601,20905506,58860398,924948600.368900,1004382709.139300,1194002662.382000,3123333971.890200,462452,122163,423049,1007664
2022-05-26,NYSE National (C),41100332,24797077,25953262,91850671,946005087.362600,1115045747.693500,840080745.116000,2901131580.172100,435580,150556,322584,908720
2022-05-26,FINRA / Nasdaq TRF Chicago (DB),8500616,2452585,10413091,21366292,304884559.992100,120965262.561000,811933314.492000,1237783137.045100,39290,8917,59904,108111
2022-05-26,FINRA / NYSE TRF (DN),257945962,122334189,441034998,821315149,9066518006.923503,5083688496.516599,19443070004.393603,33593276507.833705,1373618,311502,1557760,3242880
2022-05-26,FINRA / Nasdaq TRF Carteret (DQ),1475435030,850492832,1782546130,4108473992,59922523129.423907,49014260489.456014,84597682110.088314,193534465728.968235,7222420,2141003,7122770,16486193
2022-05-26,MIAX Pearl (H),43385469,28073693,32531343,103990505,1016562404.181600,1265147578.438700,1517836416.894200,3799546399.514500,414288,129930,371588,915806
2022-05-26,EDGA Equities (J),61909303,35438277,48771719,146119299,2370315390.807400,1885812403.353501,2349414724.000400,6605542518.161301,949121,263081,768885,1981087
2022-05-26,EDGX Equities (K),277331886,94835170,266750477,638917533,9845162482.974203,5453445275.301402,12842156825.585801,28140764583.861406,2402734,540721,2153215,5096670
2022-05-26,LTSE (L),55898,5890,44127,105915,3510259.000000,477853.350000,1390414.437100,5378526.787100,623,60,494,1177
2022-05-26,NYSE Chicago (M),15673710,17110450,14104173,46888333,1031309925.181200,1416191243.110600,1761539059.898400,4209040228.190200,39179,4219,33864,77262
2022-05-26,NYSE (N),1009677176,40565166,82927156,1133169498,51495033876.976799,2626609875.829900,3706679598.687600,57828323351.494299,4515844,191663,737288,5444795
2022-05-26,NYSE Arca (P),241326909,318879335,366571423,926777667,9169465244.012202,20232697063.355199,18781179583.941311,48183341891.308712,2471493,1444539,3528143,7444175
2022-05-26,NASDAQ (Q),542521610,207940332,1018243527,1768705469,24151281266.958501,16455226556.139505,62552455780.262199,103158963603.360205,7174669,1540026,9326887,18041582
2022-05-26,Members Exchange (U),196955266,82722663,150687381,430365310,4995922314.642500,4342520223.977096,5123387831.083603,14461830369.703199,1581682,458003,1305329,3345014
2022-05-26,Investors Exchange (V),157863124,34122943,121082098,313068165,8599774919.271300,2612328516.954700,8315233569.524598,19527337005.750598,2026308,210602,1645254,3882164
2022-05-26,NASDAQ PSX (X),30078385,34961397,27895065,92934847,767093539.456900,1630259568.292000,1277276227.384400,3674629335.133300,252197,156519,280557,689273
2022-05-26,BYX Equities (Y),64727839,36565265,45326192,146619296,1687903699.698600,2207391126.085801,1913826106.355800,5809120932.140201,725177,210507,572467,1508151
2022-05-26,BZX Equities (Z),245741630,135263820,204723230,585728680,9172274026.897898,9744657275.247701,11321980050.430102,30238911352.575701,2982248,914386,2489912,6386546
2022-05-25,NYSE American (A),18936541,22674490,11666139,53277170,632004166.862800,828904308.493100,519574914.875000,1980483390.230900,204143,100479,138271,442893
2022-05-25,NASDAQ BX (B),24666131,14172266,22499695,61338092,1063876789.642100,946554139.379300,1241053741.775900,3251484670.797300,546148,112424,442206,1100778
2022-05-25,NYSE National (C),43296430,26740742,25795074,95832246,1037977435.783500,1166619873.679600,822257998.373300,3026855307.836400,481475,157514,325797,964786
2022-05-25,FINRA / Nasdaq TRF Chicago (DB),8237284,2434134,9685779,20357197,310352165.852900,155608657.922000,717850188.259300,1183811012.034200,37548,8968,51685,98201
2022-05-25,FINRA / NYSE TRF (DN),274051966,128355309,418821629,821228904,8412562679.929198,5349375454.094998,16950990696.060785,30712928830.084981,1314220,284782,1362839,2961841
2022-05-25,FINRA / Nasdaq TRF Carteret (DQ),1494041849,721659521,1679748969,3895450339,59090202634.862492,44544003616.381208,77642850014.199355,181277056265.443055,7081106,1898189,6406916,15386211
2022-05-25,MIAX Pearl (H),41923148,31696826,31088317,104708291,1023925868.796200,1539833831.837700,1400407383.311400,3964167083.945300,428746,145832,345451,920029
2022-05-25,EDGA Equities (J),60905074,30596712,48350911,139852697,2313462939.530600,1682443626.096700,2261580559.352601,6257487124.979901,919188,234095,703540,1856823
2022-05-25,EDGX Equities (K),282032183,100403174,265314547,647749904,9225296708.642400,5726273772.202002,11541359826.009204,26492930306.853606,2405248,581978,2025570,5012796
2022-05-25,LTSE (L),136026,24376,46408,206810,9772597.720000,5931776.880000,1495649.980600,17200024.580600,1002,142,423,1567
2022-05-25,NYSE Chicago (M),11899957,13076293,11958358,36934608,908308767.016300,1078163221.382800,1625387110.130700,3611859098.529800,54752,4160,45855,104767
2022-05-25,NYSE (N),1027141729,45433388,78905690,1151480807,49292022064.007000,2954871766.833800,3458821352.503100,55705715183.343900,5032738,212130,715871,5960739
2022-05-25,NYSE Arca (P),248043725,336433595,378077467,962554787,9119002916.742299,21306546461.977698,17794288582.040805,48219837960.760802,2540435,1555775,3513119,7609329
2022-05-25,NASDAQ (Q),574037252,224378228,1004028223,1802443703,25413491571.130096,17578073231.362702,60091223186.901450,103082787989.394248,7654240,1729265,9509541,18893046
2022-05-25,Members Exchange (U),183594374,84996573,141520363,410111310,4624370833.010501,4822768171.515900,4665982515.597300,14113121520.123701,1525486,474658,1224365,3224509
2022-05-25,Investors Exchange (V),162329763,31262302,115531593,309123658,8885183992.222798,2333140556.941099,7996445076.571900,19214769625.735797,2127790,196360,1586711,3910861
2022-05-25,NASDAQ PSX (X),31425736,35136505,24382195,90944436,849684978.491200,1813229248.538400,1206884148.829600,3869798375.859200,262496,165883,255726,684105
2022-05-25,BYX Equities (Y),68571118,31998199,46137774,146707091,1718333484.229700,1981954427.693100,1891990486.585600,5592278398.508400,733153,191304,549802,1474259
2022-05-25,BZX Equities (Z),247291629,155192457,206133473,608617559,9161984111.445100,10773800166.413901,10798127345.541104,30733911623.400105,3019667,1097073,2435724,6552464
2022-05-24,NYSE American (A),19195537,26558902,12470124,58224563,632952868.636000,819474025.508300,634585668.290400,2087012562.434700,215816,113615,157746,487177
2022-05-24,NASDAQ BX (B),23064468,16229619,23308893,62602980,963345380.011300,1137358230.246900,1310067543.034300,3410771153.292500,528423,124935,473913,1127271
2022-05-24,NYSE National (C),46938352,30433242,29183388,106554982,1055027389.519400,1325964723.110600,949426886.013800,3330418998.643800,527675,174347,394290,1096312
2022-05-24,FINRA / Nasdaq TRF Chicago (DB),8553741,3078728,12204938,23837407,305765560.666000,157522997.314500,894458501.851000,1357747059.831500,38322,10621,68691,117634
2022-05-24,FINRA / NYSE TRF (DN),255568373,140561331,424687575,820817279,7905070770.508600,5702701427.530800,18368161666.152204,31975933864.191604,1337332,319839,1582686,3239857
2022-05-24,FINRA / Nasdaq TRF Carteret (DQ),1513307104,762745421,1769287920,4045340445,57577758100.516696,43555069554.141301,85961091543.748567,187093919198.406564,7411803,2221491,7381469,17014763
2022-05-24,MIAX Pearl (H),47079682,37059015,33734723,117873420,1046733837.088700,1709751176.922100,1420862640.916500,4177347654.927300,455749,169676,391939,1017364
2022-05-24,EDGA Equities (J),69501844,41186951,54418694,165107489,2454353808.597600,2096079865.577600,2586787537.238900,7137221211.414100,1024161,307362,824681,2156204
2022-05-24,EDGX Equities (K),286381145,114691197,279739884,680812226,8954897041.795904,6157560491.487202,12723435453.869903,27835892987.153009,2489250,623396,2263223,5375869
2022-05-24,LTSE (L),82442,21208,32662,136312,5203064.820000,8178233.500000,782658.222600,14163956.542600,961,238,410,1609
2022-05-24,NYSE Chicago (M),21325576,8249350,13798893,43373819,1321308345.965100,526823848.649600,1848406694.040800,3696538888.655500,52834,3299,44535,100668
2022-05-24,NYSE (N),1014527436,51174348,87709828,1153411612,46253568257.650101,3200728366.864000,3834253344.854400,53288549969.368501,5154457,240994,784898,6180349
2022-05-24,NYSE Arca (P),257265878,392382305,381533760,1031181943,8866683803.115601,23306185933.620199,19372221645.650688,51545091382.386488,2631712,1739887,3796864,8168463
2022-05-24,NASDAQ (Q),596994801,256029767,1029217872,1882242440,24804170731.617093,19441834567.189094,61804675925.560412,106050681224.366599,7779839,1971750,10127842,19879431
2022-05-24,Members Exchange (U),198719530,94888430,160412526,454020486,4856538320.304901,5158659959.323401,5319667338.149299,15334865617.777601,1631136,554653,1389255,3575044
2022-05-24,Investors Exchange (V),177102125,33371988,123560472,334034585,9121900652.174899,2621231977.473799,8956646413.975900,20699779043.624598,2285568,217931,1778135,4281634
2022-05-24,NASDAQ PSX (X),33210321,44395743,28800191,106406255,860148434.880000,2233140902.060000,1580593877.487100,4673883214.427100,269599,212688,301369,783656
2022-05-24,BYX Equities (Y),76802424,37309781,46679650,160791855,1732121413.876000,2305814448.745600,1973455163.709000,6011391026.330600,770306,216145,590783,1577234
2022-05-24,BZX Equities (Z),277569992,174886025,213649473,666105490,9433526182.435402,11162546527.109000,12060540872.914901,32656613582.459303,3224035,1161363,2654255,7039653
2022-05-23,NYSE American (A),17724007,24330679,11222802,53277488,618009324.183900,815839750.414800,484828767.141300,1918677841.740000,199005,108755,134029,441789
2022-05-23,NASDAQ BX (B),20587481,14651369,20865258,56104108,966148972.551500,1068200812.623000,1286347093.306100,3320696878.480600,495694,119730,441332,1056756
2022-05-23,NYSE National (C),41885887,27360527,26188945,95435359,1036573194.528300,1149918854.692800,921491747.106900,3107983796.328000,497568,164320,362857,1024745
2022-05-23,FINRA / Nasdaq TRF Chicago (DB),7489326,2593822,12189397,22272545,288556718.101400,150667295.941100,749860327.372500,1189084341.415000,34928,9707,58841,103476
2022-05-23,FINRA / NYSE TRF (DN),214326980,131338545,438028454,783693979,7970136387.442205,5316190145.586496,17862906835.478718,31149233368.507419,1243214,311189,1533790,3088193
2022-05-23,FINRA / Nasdaq TRF Carteret (DQ),1366962713,763272210,1719159432,3849394355,58724787396.231605,40211248434.831508,81441337547.783480,180377373378.846593,6936907,2177494,6977598,16091999
2022-05-23,MIAX Pearl (H),42089972,30797426,32069223,104956621,1030867416.807000,1387285468.678900,1382625093.580400,3800777979.066300,420167,150521,357132,927820
2022-05-23,EDGA Equities (J),57843671,35777618,50065569,143686858,2213488538.873400,1874495674.416000,2313659686.898800,6401643900.188200,890387,277661,733409,1901457
2022-05-23,EDGX Equities (K),245757326,103236835,272518192,621512353,8829152305.080699,5571443270.713201,11865490060.131399,26266085635.925299,2245157,578662,2072212,4896031
2022-05-23,LTSE (L),112146,50200,34157,196503,4995306.180000,19807942.700000,833681.064900,25636929.944900,862,154,427,1443
2022-05-23,NYSE Chicago (M),15100329,8321947,12122403,35544679,914660949.749900,793758449.906400,1748094776.177001,3456514175.833301,52974,4926,42836,100736
2022-05-23,NYSE (N),970601256,43497432,75127577,1089226265,46994921459.359496,2941264904.726800,3307116249.410600,53243302613.496896,4660454,223174,692443,5576071
2022-05-23,NYSE Arca (P),226828104,348663075,364098787,939589966,8597037185.919504,21464893470.364487,19059787822.619410,49121718478.903401,2386684,1640645,3598803,7626132
2022-05-23,NASDAQ (Q),532722573,234255571,984548630,1751526774,23817592415.593803,18085768292.034195,59244215814.786735,101147576522.414733,7198133,1774997,9381723,18354853
2022-05-23,Members Exchange (U),177923646,82386663,159477305,419787614,4539691847.208500,4305962153.245102,4675479536.683500,13521133537.137102,1483203,498164,1294822,3276189
2022-05-23,Investors Exchange (V),152579977,30625480,105168043,288373500,8150678593.227800,2277277442.432800,7093716380.936498,17521672416.597098,2024273,195868,1533525,3753666
2022-05-23,NASDAQ PSX (X),28891118,40784444,26596634,96272196,757374658.530800,1969430932.696100,1443347745.933900,4170153337.160800,245532,197885,270273,713690
2022-05-23,BYX Equities (Y),64959483,33664544,45024777,143648804,1723254965.530400,2156611033.374501,1978065434.233299,5857931433.138200,711791,199931,553931,1465653
2022-05-23,BZX Equities (Z),235650522,153425465,197695362,586771349,8653004174.480899,9948702179.203097,10813218530.332608,29414924884.016604,2877205,1045078,2442813,6365096
2022-05-20,NYSE American (A),20333524,28519969,15030331,63883824,722787397.006000,1115555228.988900,759809535.852100,2598152161.847000,227512,133069,178626,539207
2022-05-20,NASDAQ BX (B),24856562,17752374,28042453,70651389,1123437028.705800,1224239754.678500,1775996486.993800,4123673270.378100,536753,146929,516352,1200034
2022-05-20,NYSE National (C),48389808,34670145,32781764,115841717,1157993791.634700,1524612872.537800,1179725769.060400,3862332433.232900,505222,218112,376732,1100066
2022-05-20,FINRA / Nasdaq TRF Chicago (DB),7838682,3619877,32283220,43741779,350320987.006500,188023555.742600,1201846565.953500,1740191108.702600,37531,13195,75570,126296
2022-05-20,FINRA / NYSE TRF (DN),248831616,170444662,465492307,884768585,9012949769.547001,7331838338.688401,21597377919.264289,37942166027.499691,1368370,386819,1807206,3562395
2022-05-20,FINRA / Nasdaq TRF Carteret (DQ),1499014710,890266317,1925404436,4314685463,63126719508.726904,54310357969.148178,97496709778.549680,214933787256.424762,7659231,2638274,8090114,18387619
2022-05-20,MIAX Pearl (H),50867912,41937166,43118329,135923407,1187908910.014900,2027028899.809000,1941139512.346099,5156077322.169999,480504,193915,449982,1124401
2022-05-20,EDGA Equities (J),67680679,44607095,58220175,170507949,2533698184.860300,2353520186.067901,2921086512.666300,7808304883.594501,987904,350556,844435,2182895
2022-05-20,EDGX Equities (K),278271868,123951080,303499098,705722046,9916962104.564001,7367321264.785502,15407838008.746093,32692121378.095596,2620482,735531,2566233,5922246
2022-05-20,LTSE (L),56566,11246,72804,140616,2314814.880000,4052168.440000,10447903.753000,16814887.073000,595,34,812,1441
2022-05-20,NYSE Chicago (M),19646552,18670218,18633875,56950645,1001870888.752700,2471631371.903600,3583396212.243601,7056898472.899901,74014,5541,61841,141396
2022-05-20,NYSE (N),1189251740,54924721,96732867,1340909328,58975151779.579795,3789085002.558201,4324536537.588500,67088773319.726496,5527740,276129,832179,6636048
2022-05-20,NYSE Arca (P),263234522,423785495,420423399,1107443416,9916802577.985793,26917798949.190889,24033136871.393218,60867738398.569900,2759128,2089664,4313885,9162677
2022-05-20,NASDAQ (Q),628525005,300122584,1320965259,2249612848,28764513852.149796,23384339133.245287,78548818234.212942,130697671219.608025,8562994,2286231,11320024,22169249
2022-05-20,Members Exchange (U),204117085,105972034,186992079,497081198,5112473139.788700,6201328823.488299,6257346208.399301,17571148171.676300,1688770,652763,1566447,3907980
2022-05-20,Investors Exchange (V),173640626,36964646,129220786,339826058,9490310612.651402,3090515423.275900,8987245801.585503,21568071837.512805,2288902,243184,1779421,4311507
2022-05-20,NASDAQ PSX (X),33531557,49351636,36335189,119218382,894224393.977300,2520569777.658500,1830973449.962499,5245767621.598299,291810,228667,351817,872294
2022-05-20,BYX Equities (Y),74908067,42336757,57714725,174959549,1927601080.561700,2632260384.443400,2546992299.744400,7106853764.749500,789394,251555,676305,1717254
2022-05-20,BZX Equities (Z),297734604,203851394,263411047,764997045,11117633624.981900,14447705754.173202,15855722181.371698,41421061560.526800,3548328,1419366,3179128,8146822
2022-05-19,NYSE American (A),20634904,27882571,14624765,63142240,739937154.683700,1014770441.683000,747057892.800600,2501765489.167300,237015,136578,171790,545383
2022-05-19,NASDAQ BX (B),26550837,18333972,26127228,71012037,1189855705.591500,1259787248.692600,1502186158.189199,3951829112.473299,601165,147135,524263,1272563
2022-05-19,NYSE National (C),47011512,31292690,31666428,109970630,1108685601.921800,1394878220.078900,967282598.902000,3470846420.902700,517707,197843,377552,1093102
2022-05-19,FINRA / Nasdaq TRF Chicago (DB),7535641,3854419,12643833,24033893,332209417.729000,163395050.657700,956773911.490100,1452378379.876800,38349,14213,66646,119208
2022-05-19,FINRA / NYSE TRF (DN),247778997,152065979,444167899,844012875,9437666448.023096,6467035924.227001,20325483226.300307,36230185598.550404,1348605,347705,1655268,3351578
2022-05-19,FINRA / Nasdaq TRF Carteret (DQ),1541470453,931805114,1883850420,4357125987,66092233366.074208,51948226210.856409,90001065886.400480,208041525463.331097,7631067,2501912,7475255,17608234
2022-05-19,MIAX Pearl (H),49912411,43468880,39022442,132403733,1185584569.529500,2015501393.539999,1646978014.757100,4848063977.826599,473437,205557,408721,1087715
2022-05-19,EDGA Equities (J),70764769,45252671,58510338,174527778,2673736718.777900,2434468527.622699,2883964068.641699,7992169315.042298,1051444,343543,873856,2268843
2022-05-19,EDGX Equities (K),274883757,128918297,296886333,700688387,9987773656.246205,7142276537.212495,14073658538.168404,31203708731.627104,2600228,761504,2446047,5807779
2022-05-19,LTSE (L),29401,1621,36319,67341,1569587.760000,74716.080000,1132065.996800,2776369.836800,406,19,316,741
2022-05-19,NYSE Chicago (M),10638875,10959881,14647928,36246684,810509830.408000,1187596237.968700,2294372815.789202,4292478884.165902,69985,5467,55572,131024
2022-05-19,NYSE (N),1109758814,54802526,91787309,1256348649,51276530450.719398,3393677531.422500,3954265583.989200,58624473566.131098,5878888,276665,811947,6967500
2022-05-19,NYSE Arca (P),257315219,438045141,405751115,1101111475,10009057470.224199,26669475109.739998,21957319242.969807,58635851822.934004,2783039,2075378,4217508,9075925
2022-05-19,NASDAQ (Q),631434915,310858397,1174866501,2117159813,28846882590.084785,23027903715.784901,68223651784.208575,120098438090.078261,8691605,2398836,11419355,22509796
2022-05-19,Members Exchange (U),209214954,113708029,178074510,500997493,5246058708.436901,6033388634.103901,5797998186.975104,17077445529.515906,1719359,660504,1515387,3895250
2022-05-19,Investors Exchange (V),200170184,40095148,148255981,388521313,11388715912.156399,2932711501.763600,9845594426.638396,24167021840.558395,2529801,253736,1947007,4730544
2022-05-19,NASDAQ PSX (X),34664870,50362204,31318007,116345081,981153932.266500,2503265670.790000,1646803031.506600,5131222634.563100,313812,237942,333133,884887
2022-05-19,BYX Equities (Y),75990794,42209710,53379228,171579732,1963817625.815000,2698559214.133699,2194493192.600299,6856870032.548998,800012,253681,643883,1697576
2022-05-19,BZX Equities (Z),297791155,216160508,248799870,762751533,10697931255.905600,14775763703.063186,13299477526.231199,38773172485.199985,3551455,1488586,3101529,8141570
2022-05-18,NYSE American (A),19940981,30535763,13765074,64241818,797724541.176900,1414673187.766700,745415946.594800,2957813675.538400,230465,138586,164586,533637
2022-05-18,NASDAQ BX (B),24721624,18548613,25669253,68939490,1172738072.015100,1433254394.955600,1544582814.311000,4150575281.281700,532755,142417,464218,1139390
2022-05-18,NYSE National (C),45713030,30840015,30855596,107408641,1106831630.409800,1347109200.233500,1038383041.805400,3492323872.448700,474637,183488,349282,1007407
2022-05-18,FINRA / Nasdaq TRF Chicago (DB),9136145,3514150,13084775,25735070,395244201.020500,179431292.574300,914316597.863800,1488992091.458600,45109,15275,68889,129273
2022-05-18,FINRA / NYSE TRF (DN),258711102,147606686,432511515,838829303,9992224600.719103,6052897364.677300,18679286907.642903,34724408873.039306,1548575,402018,1721735,3672328
2022-05-18,FINRA / Nasdaq TRF Carteret (DQ),1589081112,999525753,1916023187,4504630052,68455035461.968185,61292032214.786662,90018019045.418871,219765086722.173718,7991595,2567368,7685077,18244040
2022-05-18,MIAX Pearl (H),43664666,36342588,35141625,115148879,1062929158.474000,1755742890.507900,1527645895.097100,4346317944.079000,449385,167474,392928,1009787
2022-05-18,EDGA Equities (J),68804401,45151700,56269219,170225320,2641790920.894200,2350055293.685200,2735505307.159000,7727351521.738400,1015941,319588,814902,2150431
2022-05-18,EDGX Equities (K),286637792,132282112,301193894,720113798,10760050908.909203,7623468486.635002,14003705155.334013,32387224550.878218,2774742,777312,2515665,6067719
2022-05-18,LTSE (L),28268,19402,40931,88601,4855044.920000,6920548.510000,703971.283200,12479564.713200,448,104,241,793
2022-05-18,NYSE Chicago (M),11701740,8810403,15281167,35793310,773109171.361600,994144647.630000,2346252060.514000,4113505879.505600,55934,3803,50813,110550
2022-05-18,NYSE (N),1139581008,55354880,86005825,1280941713,54850459229.343206,3624012735.437800,3802712918.563999,62277184883.345005,5532457,252020,762898,6547375
2022-05-18,NYSE Arca (P),270556416,414388236,388222729,1073167381,11174600075.950700,27872283233.641111,21256980504.178106,60303863813.769917,2910168,1943575,4058832,8912575
2022-05-18,NASDAQ (Q),552711932,246116485,1120700253,1919528670,25448668116.584299,19650793493.556704,68495146431.398976,113594608041.539979,7597061,1794879,9794299,19186239
2022-05-18,Members Exchange (U),205320622,106399586,171012020,482732228,5290602762.742202,5823704174.318601,5275665818.750000,16389972755.810803,1718079,613402,1425541,3757022
2022-05-18,Investors Exchange (V),182033579,38289397,131643044,351966020,10298890405.501799,3068431777.593299,9551770011.826797,22919092194.921895,2352920,236836,1788455,4378211
2022-05-18,NASDAQ PSX (X),31769518,42733534,29790550,104293602,937019578.250100,2248288168.667201,1470252108.040800,4655559854.958101,297973,204699,308481,811153
2022-05-18,BYX Equities (Y),73889347,42618121,52018990,168526458,1907617620.241600,2734880282.752700,2259192997.365100,6901690900.359400,754710,239305,623361,1617376
2022-05-18,BZX Equities (Z),289219070,198672136,244890839,732782045,11108727893.504301,13928686270.649404,13691250335.860893,38728664500.014598,3726475,1324806,3163818,8215099
2022-05-17,NYSE American (A),18037361,28169003,12802251,59008615,671291331.618100,905751238.117000,602521980.891400,2179564550.626500,200412,121333,146812,468557
2022-05-17,NASDAQ BX (B),24948816,15227390,24403356,64579562,1083527515.367100,1042583717.671700,1259323718.280700,3385434951.319500,518037,115255,444685,1077977
2022-05-17,NYSE National (C),43601497,29673828,29885715,103161040,1009065028.475000,1269890729.292400,827639253.974900,3106595011.742300,472505,174773,344557,991835
2022-05-17,FINRA / Nasdaq TRF Chicago (DB),8584539,4124394,14412142,27121075,357970591.790900,146312136.194200,899886331.121100,1404169059.106200,41826,11933,67863,121622
2022-05-17,FINRA / NYSE TRF (DN),253818123,142032643,473905008,869755774,9257917006.518600,5445883127.595798,18133615988.253996,32837416122.368394,1388313,327710,1554947,3270970
2022-05-17,FINRA / Nasdaq TRF Carteret (DQ),1512841269,796434780,1940489168,4249765217,63512351415.286203,43403676991.261097,81218926697.334368,188134955103.881668,7119592,2193497,6951226,16264315
2022-05-17,MIAX Pearl (H),42501167,35543692,35254137,113298996,1081788801.282400,1580636030.625100,1349652317.449700,4012077149.357200,441193,167055,376657,984905
2022-05-17,EDGA Equities (J),62694709,37583897,54462126,154740732,2457641142.967200,1898589167.457500,2328866863.197700,6685097173.622400,929265,281519,762459,1973243
2022-05-17,EDGX Equities (K),277939132,114615267,298981596,691535995,10270736008.134101,5828574268.587397,12438548806.348501,28537859083.069999,2466731,620237,2191237,5278205
2022-05-17,LTSE (L),29584,1003,15078,45665,1325180.720000,48149.190000,661183.420000,2034513.330000,327,10,231,568
2022-05-17,NYSE Chicago (M),14465357,8175716,12825226,35466299,1084246298.258000,952949925.470000,1606760099.082700,3643956322.810700,50944,3300,45201,99445
2022-05-17,NYSE (N),1019940878,47726493,78208372,1145875743,48349299802.357404,3036154379.444200,3265391652.208800,54650845834.010404,4956985,219016,695840,5871841
2022-05-17,NYSE Arca (P),248989774,381824842,391570737,1022385353,9391137098.344699,22868998041.262900,18066335412.063097,50326470551.670696,2592972,1668960,3650577,7912509
2022-05-17,NASDAQ (Q),582162823,259452188,1121287596,1962902607,26165532585.669906,18526150645.745390,61067407906.795436,105759091138.210732,7684188,1827984,9790673,19302845
2022-05-17,Members Exchange (U),194143716,100380762,172757768,467282246,5352164015.862300,4981321707.686001,5243470941.739500,15576956665.287801,1668364,548176,1436030,3652570
2022-05-17,Investors Exchange (V),171978366,35920874,123746718,331645958,9441128510.719400,2762191649.835100,7815056677.029402,20018376837.583902,2118765,226834,1660079,4005678
2022-05-17,NASDAQ PSX (X),33879842,41216637,28012146,103108625,906437532.900000,1837815086.430400,1269844822.502300,4014097441.832700,277639,178898,279716,736253
2022-05-17,BYX Equities (Y),69482098,38176411,52007779,159666288,1756167494.578500,2312763961.979700,1837955107.079599,5906886563.637799,705171,218403,575534,1499108
2022-05-17,BZX Equities (Z),261374560,173120076,228942717,663437353,9854483670.078600,11422518484.236503,11479600364.486402,32756602518.801505,3182712,1145113,2684575,7012400
2022-05-16,NYSE American (A),16663956,24866077,12325952,53855985,560549311.495000,768408340.019700,497560150.917500,1826517802.432200,186248,113786,144232,444266
2022-05-16,NASDAQ BX (B),19964227,13279509,22229985,55473721,899133165.447300,1032359526.810900,1213984634.566600,3145477326.824800,464378,109162,412737,986277
2022-05-16,NYSE National (C),41319544,25014397,30379463,96713404,995914892.030600,1054188606.253800,928507539.276300,2978611037.560700,482800,158014,370038,1010852
2022-05-16,FINRA / Nasdaq TRF Chicago (DB),7818083,3137452,14464286,25419821,330175099.416100,176251925.418600,856019519.155700,1362446543.990400,40807,12452,65540,118799
2022-05-16,FINRA / NYSE TRF (DN),224213677,136565449,482547553,843326679,7856250889.812401,5003768105.427500,17403929769.129199,30263948764.369100,1352036,326323,1648533,3326892
2022-05-16,FINRA / Nasdaq TRF Carteret (DQ),1355840353,771248475,1860508348,3987597176,56123631891.676298,41082492752.721898,76878306403.020662,174084431047.418858,6859389,2184378,6960711,16004478
2022-05-16,MIAX Pearl (H),37221561,32793335,36954630,106969526,883263779.679300,1492187865.293000,1316006785.171800,3691458430.144100,396373,167879,385014,949266
2022-05-16,EDGA Equities (J),60769313,33367251,50256647,144393211,2246995246.022500,1703674410.867600,2218996068.567100,6169665725.457200,908777,250080,729442,1888299
2022-05-16,EDGX Equities (K),254290061,106959959,281259538,642509558,8668263549.781402,6105010896.058101,11697072106.195095,26470346552.034598,2302532,598582,2150019,5051133
2022-05-16,LTSE (L),25304,822,14159,40285,1640292.040000,4586.980000,619757.460000,2264636.480000,395,8,262,665
2022-05-16,NYSE Chicago (M),11444860,10605975,8475852,30526687,600820544.487900,1161034071.574000,1496025434.270200,3257880050.332100,50080,3321,46302,99703
2022-05-16,NYSE (N),945544255,40543276,78316589,1064404120,44033345710.211393,2454308490.850500,3096990728.597300,49584644929.659193,4828499,194557,680037,5703093
2022-05-16,NYSE Arca (P),230403101,350248825,386300986,966952912,8280835622.519297,21212646927.206197,17111507922.811284,46604990472.536778,2423871,1587260,3557868,7568999
2022-05-16,NASDAQ (Q),538118931,240811445,1072015511,1850945887,23303792890.721204,17789116784.709508,55066842093.986096,96159751769.416808,7337411,1859927,9746472,18943810
2022-05-16,Members Exchange (U),184251772,93233312,171132244,448617328,4741760040.067300,4833250840.459701,5055106014.662201,14630116895.189202,1598563,516632,1416075,3531270
2022-05-16,Investors Exchange (V),152698869,30833246,116922355,300454470,8268789096.671000,2318824258.766000,7169612251.235900,17757225606.672900,2052127,185699,1596500,3834326
2022-05-16,NASDAQ PSX (X),28245863,38522013,26557867,93325743,747567879.033400,1859342322.635299,1154499866.707900,3761410068.376599,250205,171310,264224,685739
2022-05-16,BYX Equities (Y),61774643,31852072,48666809,142293524,1522128714.408300,1853290487.100701,1805816848.450100,5181236049.959101,671947,182528,573597,1428072
2022-05-16,BZX Equities (Z),244423336,157960241,230930148,633313725,8427730298.774400,10380074999.198502,10349988624.206803,29157793922.179705,2961790,1112113,2622313,6696216
2022-05-13,NYSE American (A),19135228,29822363,15776919,64734510,675202568.840200,935283396.055600,696682479.922100,2307168444.817900,217930,129266,182454,529650
2022-05-13,NASDAQ BX (B),25087188,18057474,27977793,71122455,1047393025.851000,1555623877.993000,1653347925.849600,4256364829.693600,525700,146241,520047,1191988
2022-05-13,NYSE National (C),47584263,28896648,39342444,115823355,1121340927.666600,1302320336.746900,1056168886.846500,3479830151.260000,551688,180829,444553,1177070
2022-05-13,FINRA / Nasdaq TRF Chicago (DB),9203678,2972112,16392310,28568100,367151672.889400,133915367.903100,934507509.784100,1435574550.576600,41836,12860,74495,129191
2022-05-13,FINRA / NYSE TRF (DN),254859220,157219919,522183457,934262596,8598894312.828905,6009480842.520896,19071084116.172508,33679459271.522309,1399573,342770,1770259,3512602
2022-05-13,FINRA / Nasdaq TRF Carteret (DQ),1568379182,922247295,2174847257,4665473734,63422794574.313920,51264878995.766905,92932816935.193226,207620490505.274051,7815542,2364424,8155097,18335063
2022-05-13,MIAX Pearl (H),41853296,37787214,41420338,121060848,1027091908.944200,1811619144.767500,1662285956.300400,4500997010.012100,451868,185397,421496,1058761
2022-05-13,EDGA Equities (J),74175454,42139113,65691449,182006016,2597831846.850000,2114553492.324100,2924015823.653601,7636401162.827701,1056468,316472,937479,2310419
2022-05-13,EDGX Equities (K),304025807,129952496,337892557,771870860,9968280309.718298,6939124373.441399,13961479731.756700,30868884414.916397,2634037,698370,2581368,5913775
2022-05-13,LTSE (L),17255,2945,27276,47476,1433197.650000,414129.910000,1227939.160000,3075266.720000,289,36,355,680
2022-05-13,NYSE Chicago (M),20795673,15447972,15540954,51784599,897054326.707500,1882019715.094000,2184747547.477199,4963821589.278699,66700,4933,59296,130929
2022-05-13,NYSE (N),1111592689,53052871,94444679,1259090239,49414375985.834803,3627978642.032599,3808513155.737499,56850867783.604901,5538204,238954,821563,6598721
2022-05-13,NYSE Arca (P),269003175,412631965,460115331,1141750471,9606679316.564298,25733413617.587292,21327184132.838894,56667277066.990484,2737956,1824244,4220725,8782925
2022-05-13,NASDAQ (Q),635945513,296903993,1349937391,2282786897,27330444377.503996,22971337668.195090,72347396833.952217,122649178879.651303,8513635,2205728,11681985,22401348
2022-05-13,Members Exchange (U),219228029,108872421,195349096,523449546,5384335132.836400,6009091899.510099,6121976225.028701,17515403257.375200,1849753,594644,1653158,4097555
2022-05-13,Investors Exchange (V),181634530,37138393,159026893,377799816,9432535607.157096,2821946350.409701,9163136833.102103,21417618790.668900,2338445,252944,2025975,4617364
2022-05-13,NASDAQ PSX (X),35641561,38356342,40336330,114334233,924598491.080300,2107241697.147500,1698333008.327000,4730173196.554800,320633,188224,358206,867063
2022-05-13,BYX Equities (Y),73770225,41705672,58125104,173601001,1860880719.579800,2688642079.260000,2345747013.479101,6895269812.318901,767748,243748,678285,1689781
2022-05-13,BZX Equities (Z),291415077,178181594,279601974,749198645,9944520478.814101,11615521799.119294,14194278535.967606,35754320813.901001,3462129,1195603,3214468,7872200
2022-05-12,NYSE American (A),22667053,36050788,17901731,76619572,807323888.551300,1225601845.894400,883952018.037500,2916877752.483200,251032,158615,207004,616651
2022-05-12,NASDAQ BX (B),31635947,25440418,39418389,96494754,1317985459.610800,1789658768.047300,2358894708.055299,5466538935.713399,676844,196047,689080,1561971
2022-05-12,NYSE National (C),63165898,44976079,49054781,157196758,1369540766.533900,1873478718.591700,1439550513.123000,4682569998.248600,647042,265728,535777,1448547
2022-05-12,FINRA / Nasdaq TRF Chicago (DB),11088045,3620304,17196103,31904452,410010716.869100,139097443.239800,1188251890.253800,1737360050.362700,51281,15664,85352,152297
2022-05-12,FINRA / NYSE TRF (DN),314447573,184655143,555244795,1054347511,10072300122.683997,6987369744.059801,22052803417.858092,39112473284.601890,1679183,420452,1992895,4092530
2022-05-12,FINRA / Nasdaq TRF Carteret (DQ),1820957986,1084257699,2315769860,5220985545,70875476057.048001,57745582284.411084,104101926969.217175,232722985310.676260,8963860,3004718,9047143,21015721
2022-05-12,MIAX Pearl (H),51922520,69448690,50105613,171476823,1280740724.555900,3250510014.945300,2262806707.624000,6794057447.125200,525593,329098,474982,1329673
2022-05-12,EDGA Equities (J),89127444,62809974,83866359,235803777,3099059611.263700,3131064767.891100,3897755063.494799,10127879442.649599,1239920,478549,1147095,2865564
2022-05-12,EDGX Equities (K),372832265,175043824,387792342,935668431,11430516292.263398,10030144798.784403,17605945681.271611,39066606772.319412,3243768,1035616,3167389,7446773
2022-05-12,LTSE (L),25005,34930,132237,192172,1383642.120000,13601052.250000,34024206.570000,49008900.940000,338,82,1600,2020
2022-05-12,NYSE Chicago (M),20976624,17749423,15752710,54478757,1308788464.942100,1954731352.058200,3282822647.999300,6546342464.999600,99450,4757,79944,184151
2022-05-12,NYSE (N),1338097119,78201560,117325604,1533624283,57306521467.083797,4662803237.853798,5124789935.179702,67094114640.117297,6889754,352914,1042848,8285516
2022-05-12,NYSE Arca (P),343704142,576709843,570081073,1490495058,11653141826.377201,34486788135.245404,29115253218.580517,75255183180.203122,3459394,2775571,5369201,11604166
2022-05-12,NASDAQ (Q),806712114,446079835,1576373384,2829165333,32955555044.672394,33931522816.655118,88531483641.494158,155418561502.821670,10308009,3617404,14608285,28533698
2022-05-12,Members Exchange (U),266570126,163419927,225731917,655721970,6151816538.283100,8467326244.842701,7769843650.806801,22388986433.932602,2156976,885790,1954829,4997595
2022-05-12,Investors Exchange (V),225407986,48708819,189076920,463193725,11817527901.776299,3786320546.764701,11458265094.907899,27062113543.448899,2872887,300496,2376873,5550256
2022-05-12,NASDAQ PSX (X),40742230,63455965,43961639,148159834,1089899671.512500,3230977605.237399,2179306133.255201,6500183410.005100,346322,339163,429097,1114582
2022-05-12,BYX Equities (Y),90261474,54479151,70973777,215714402,2251761987.704000,3169687053.284001,2933525010.858502,8354974051.846503,961375,304453,858910,2124738
2022-05-12,BZX Equities (Z),376115298,278234851,353716400,1008066549,12305120506.387801,17890303555.917900,19522994302.400597,49718418364.706298,4309817,1941431,4175830,10427078
2022-05-11,NYSE American (A),21894270,35188942,18330995,75414207,773924709.937300,1409220143.064700,998107390.503800,3181252243.505800,246852,159724,208815,615391
2022-05-11,NASDAQ BX (B),32338025,22936045,34498057,89772127,1279239114.124200,1865641534.270100,2089103255.224300,5233983903.618600,622268,163687,618910,1404865
2022-05-11,NYSE National (C),56094521,43625529,45127318,144847368,1333073317.558600,1833493641.844600,1442190806.542800,4608757765.946000,591037,244689,487838,1323564
2022-05-11,FINRA / Nasdaq TRF Chicago (DB),10736341,4314584,16758816,31809741,392292847.427300,179731837.023000,930886735.334700,1502911419.785000,50036,15424,81864,147324
2022-05-11,FINRA / NYSE TRF (DN),296071320,171021757,477340934,944434011,8681548762.980202,6358735686.149802,19467974205.654895,34508258654.784899,1514029,383530,1881294,3778853
2022-05-11,FINRA / Nasdaq TRF Carteret (DQ),1721559405,1145585444,2181003421,5048148270,64398048320.709794,62862996849.886099,99653761094.073382,226914806264.669275,8096181,2657732,8566240,19320153
2022-05-11,MIAX Pearl (H),52343738,82698595,52725531,187767864,1246563156.068700,4053813692.716399,2518398841.090799,7818775689.875898,517017,365970,506554,1389541
2022-05-11,EDGA Equities (J),88378672,74380115,82764989,245523776,3220644910.144900,4295628253.717399,4431749652.724199,11948022816.586498,1213070,567420,1136996,2917486
2022-05-11,EDGX Equities (K),350171812,176297737,342937125,869406674,10616389962.304898,10815903422.036205,16348221766.427195,37780515150.768298,2995786,1054498,2959749,7010033
2022-05-11,LTSE (L),71802,28016,154645,254463,3010540.610000,10904667.260000,9736841.900000,23652049.770000,422,126,386,934
2022-05-11,NYSE Chicago (M),11273255,10705385,15750974,37729614,974333309.565600,1278089229.919800,3020929995.740800,5273352535.226200,101834,4392,78957,185183
2022-05-11,NYSE (N),1205547108,89469078,111383192,1406399378,53050128537.049896,6304086990.178298,4921797173.405498,64276012700.633692,6150834,425239,959720,7535793
2022-05-11,NYSE Arca (P),331632653,589907165,501014186,1422554004,10944318978.036800,37609238039.187684,28724535944.402401,77278092961.626885,3161597,2883118,4982415,11027130
2022-05-11,NASDAQ (Q),724866559,487761823,1446838374,2659466756,29962138007.980403,38638844730.896585,84351003026.410085,152951985765.287073,9239181,3928393,13314526,26482100
2022-05-11,Members Exchange (U),249086059,179722342,221208723,650017124,6242439971.010800,10425999327.364800,7945472529.615095,24613911827.990695,2054372,1021526,1896646,4972544
2022-05-11,Investors Exchange (V),204723811,43054562,171485817,419264190,10778251518.131599,3274906498.442099,10640016489.055698,24693174505.629396,2605800,264204,2170613,5040617
2022-05-11,NASDAQ PSX (X),38846932,72740363,42259878,153847173,1118206556.829700,3922578077.031902,2435552693.357000,7476337327.218602,332084,357394,410526,1100004
2022-05-11,BYX Equities (Y),83914141,54768321,66152795,204835257,2140690231.736700,3633965012.012201,2913321098.770700,8687976342.519601,876404,299110,775387,1950901
2022-05-11,BZX Equities (Z),336598322,299958799,324640165,961197286,11501370201.632698,21727183952.498502,19547580501.323414,52776134655.454614,3960361,2083954,3813033,9857348
2022-05-10,NYSE American (A),23140918,33213103,18433053,74787074,865165688.252200,1320774169.723800,852904688.418500,3038844546.394500,277547,159997,225920,663464
2022-05-10,NASDAQ BX (B),30518601,23582684,37172765,91274050,1320323002.370800,1704242984.217300,1991569050.879100,5016135037.467200,654799,178189,650154,1483142
2022-05-10,NYSE National (C),56136774,47367817,44521186,148025777,1306039712.375100,1992744613.902700,1433919417.394800,4732703743.672600,625480,256045,515612,1397137
2022-05-10,FINRA / Nasdaq TRF Chicago (DB),11436509,4099499,17999748,33535756,416838363.715500,166664803.569200,961210602.935000,1544713770.219700,51352,15442,81300,148094
2022-05-10,FINRA / NYSE TRF (DN),288193087,167339679,493684704,949217470,9002533899.963198,6807126735.587101,20286393082.211592,36096053717.761891,1590121,398682,1894253,3883056
2022-05-10,FINRA / Nasdaq TRF Carteret (DQ),1732161637,1113910011,2223976059,5070047707,67979287316.100918,64049863497.450302,101289553423.302842,233318704236.854062,8698952,2917276,8795499,20411727
2022-05-10,MIAX Pearl (H),49591147,71986768,47562834,169140749,1340569176.323100,3680851318.551899,2212460668.514000,7233881163.388999,520558,345679,451867,1318104
2022-05-10,EDGA Equities (J),87968683,67874216,90490776,246333675,3426849690.903500,4058344757.103000,4519147711.891799,12004342159.898299,1301103,537646,1217439,3056188
2022-05-10,EDGX Equities (K),340045763,169514419,346807395,856367577,10825764233.630802,10053661377.994601,16048488092.910691,36927913704.536094,3141499,1057935,3047118,7246552
2022-05-10,LTSE (L),29655,12175,62415,104245,2133350.710000,4403617.260000,3511761.410000,10048729.380000,500,54,321,875
2022-05-10,NYSE Chicago (M),16118722,15356393,15125425,46600540,1121395424.467900,2212827236.745300,2381274508.440598,5715497169.653798,109699,5065,80898,195662
2022-05-10,NYSE (N),1234514051,81881302,107276034,1423671387,57205880047.581200,5905101348.469202,4663295626.108900,67774277022.159302,6655779,428272,987668,8071719
2022-05-10,NYSE Arca (P),317379989,572298692,503197773,1392876454,11634824414.755501,36605878292.281505,29249276256.928190,77489978963.965196,3280482,2835612,5147732,11263826
2022-05-10,NASDAQ (Q),769207677,443650729,1454328766,2667187172,33505971596.027804,35790379073.599503,84139761810.612879,153436112480.240186,10221337,3661812,13853834,27736983
2022-05-10,Members Exchange (U),244523747,170959435,210024199,625507381,6225605227.894201,10034898283.023198,7479047983.047900,23739551493.965299,2075247,1012327,1812337,4899911
2022-05-10,Investors Exchange (V),224441910,49898269,185729390,460069569,12185752542.391696,3784565517.556699,10745987106.950498,26716305166.898893,2938486,312837,2430027,5681350
2022-05-10,NASDAQ PSX (X),38281397,60020663,44902096,143204156,1134850097.432900,3107446981.597400,2268262692.200200,6510559771.230500,335050,301978,424798,1061826
2022-05-10,BYX Equities (Y),84798409,56301543,70005366,211105318,2317547074.207300,3639854327.925300,2832358200.884999,8789759603.017599,960807,321609,840551,2122967
2022-05-10,BZX Equities (Z),337338756,277178555,306969224,921486535,11568453870.940699,20140855707.674396,17475938951.667401,49185248530.282496,4080721,2015982,3815490,9912193
2022-05-09,NYSE American (A),21875197,38295163,17901725,78072085,886567655.586500,1550554548.047400,1040935785.961500,3478057989.595400,250240,167278,214710,632228
2022-05-09,NASDAQ BX (B),29217721,25507321,33451998,88177040,1324917248.992900,1926543483.144500,2074235551.654900,5325696283.792300,598856,176281,600997,1376134
2022-05-09,NYSE National (C),56760951,46141572,43543293,146445816,1372572227.246700,1966796163.462199,1420153502.345700,4759521893.054599,581986,245318,495918,1323222
2022-05-09,FINRA / Nasdaq TRF Chicago (DB),13635433,5450929,18046181,37132543,474263772.880000,209745704.469300,1022811649.715200,1706821127.064500,59529,19919,84621,164069
2022-05-09,FINRA / NYSE TRF (DN),293992786,177784132,470966527,942743445,9906184454.555204,6906382767.170300,20651086470.639601,37463653692.365105,1777369,481424,2077772,4336565
2022-05-09,FINRA / Nasdaq TRF Carteret (DQ),1787361031,1125825018,2110404694,5023590743,74692575197.952529,66068654886.788873,101592320558.610977,242353550643.352379,9322735,3581176,9415556,22319467
2022-05-09,MIAX Pearl (H),50269693,69409125,40392034,160070852,1311597612.562300,3268141870.397700,2109613318.847200,6689352801.807200,502007,309728,421019,1232754
2022-05-09,EDGA Equities (J),87937401,64950063,85853750,238741214,3560382558.554100,3681434045.477400,4391865185.090200,11633681789.121700,1292586,503836,1202746,2999168
2022-05-09,EDGX Equities (K),349601328,181061548,346248441,876911317,11417886870.857002,11234609794.127904,17434567789.411802,40087064454.396708,3243663,1120181,3139470,7503314
2022-05-09,LTSE (L),52470,32227,23007,107704,5749797.600000,12752384.110000,1504126.000000,20006307.710000,799,83,346,1228
2022-05-09,NYSE Chicago (M),10205970,8258112,10474826,28938908,804537047.513300,1126696720.346500,1932580804.233000,3863814572.092800,95874,6397,67897,170168
2022-05-09,NYSE (N),1236860761,86977766,101059967,1424898494,57828356436.820006,5248846876.687800,5100349764.875601,68177553078.383407,6329554,381181,943865,7654600
2022-05-09,NYSE Arca (P),338568428,591250301,487093398,1416912127,13354048374.855907,38045059681.431204,28963245924.327804,80362353980.614915,3554802,2889656,5157141,11601599
2022-05-09,NASDAQ (Q),748018875,436196324,1399044121,2583259320,32615472890.253686,35788059439.907898,86048184273.326513,154451716603.488097,9814803,3447470,13155066,26417339
2022-05-09,Members Exchange (U),248293745,164430466,200586650,613310861,6541976205.772603,9934668043.488198,7460365658.632498,23937009907.893299,2045558,936908,1789645,4772111
2022-05-09,Investors Exchange (V),215827761,49806042,175466309,441100112,12169680975.443301,3757411611.158100,11602109941.499300,27529202528.100701,2724117,308525,2229788,5262430
2022-05-09,NASDAQ PSX (X),38938536,62013517,36405223,137357276,1130425064.342100,3256347669.111400,2090433286.466999,6477206019.920499,333579,311339,366528,1011446
2022-05-09,BYX Equities (Y),79555210,59165500,67297347,206018057,2263501670.305900,4047402789.206901,2846254482.500600,9157158942.013401,882581,338655,811725,2032961
2022-05-09,BZX Equities (Z),347553640,280281374,294882459,922717473,12192420769.957100,20377417855.234399,17660419652.641695,50230258277.833194,4110728,1903369,3742135,9756232
2022-05-06,NYSE American (A),17096325,32624473,14545279,64266077,692492391.634000,1249030139.575400,811126658.232200,2752649189.441600,209068,143500,166673,519241
2022-05-06,NASDAQ BX (B),25948566,26849341,31210113,84008020,1219165688.327800,2314045941.024200,2340949795.376599,5874161424.728599,548605,204135,568600,1321340
2022-05-06,NYSE National (C),51880114,44756090,34077622,130713826,1372306872.977800,1940192247.751600,1205886585.653900,4518385706.383300,534244,254777,392586,1181607
2022-05-06,FINRA / Nasdaq TRF Chicago (DB),11011164,4267959,14738795,30017918,517815716.148700,152939413.377100,1078381682.383800,1749136811.909600,52150,16790,77918,146858
2022-05-06,FINRA / NYSE TRF (DN),261408872,174283805,425585979,861278656,9490631245.556590,7252087102.030304,20201414114.494398,36944132462.081292,1439427,403554,1731985,3574966
2022-05-06,FINRA / Nasdaq TRF Carteret (DQ),1521946614,927548309,1851037022,4300531945,65977930319.850516,55327781546.800591,94387060624.481824,215692772491.132931,7809261,2834400,7898987,18542648
2022-05-06,MIAX Pearl (H),44894472,71405781,49656000,165956253,1228915246.799800,3938666952.741399,2888624708.397002,8056206907.938201,472941,349082,470359,1292382
2022-05-06,EDGA Equities (J),78532382,67967408,73629087,220128877,3297113154.106400,4093142903.484499,4451478079.434498,11841734137.025397,1100443,537348,1035195,2672986
2022-05-06,EDGX Equities (K),285961568,162846534,306478615,755286717,10590462362.864898,10860500069.644800,17029236146.503697,38480198579.013395,2730246,1015881,2738478,6484605
2022-05-06,LTSE (L),55220,2849,24441,82510,3910810.410000,101320.280000,1846326.980000,5858457.670000,773,24,390,1187
2022-05-06,NYSE Chicago (M),16917192,8210108,16940573,42067873,1233595316.537700,1167688848.587800,2589672807.035900,4990956972.161400,103136,5640,77034,185810
2022-05-06,NYSE (N),1075579193,83070384,95091270,1253740847,53671196523.312610,5921205706.368100,5227114366.477301,64819516596.158011,5905243,404170,884563,7193976
2022-05-06,NYSE Arca (P),260667569,544227514,430330498,1235225581,10296841246.745096,35572338752.144805,27932896537.898804,73802076536.788705,2751117,2707327,4545407,10003851
2022-05-06,NASDAQ (Q),648951538,426425935,1257825701,2333203174,30417404739.987890,35883147288.776598,82498916818.522147,148799468847.286635,8819730,3386235,12193185,24399150
2022-05-06,Members Exchange (U),210757495,155324031,191527985,557609511,5971054418.828401,9533791222.525198,7431667201.640198,22936512842.993797,1852279,900081,1697508,4449868
2022-05-06,Investors Exchange (V),190641617,42743075,149129042,382513734,10983602532.479902,3385673441.856700,10780058032.811799,25149334007.148401,2456322,283463,1997950,4737735
2022-05-06,NASDAQ PSX (X),34504733,65526248,39884501,139915482,1212332971.499200,3450543573.950001,2837322892.867700,7500199438.316901,339740,337921,438714,1116375
2022-05-06,BYX Equities (Y),78404197,54481880,58041882,190927959,2287570148.240700,4094824639.297800,3160367434.196101,9542762221.734601,813883,328935,733667,1876485
2022-05-06,BZX Equities (Z),301788151,281723412,284731379,868242942,11413193242.508099,21479095990.576990,20793759467.043287,53686048700.128376,3573747,1892180,3557326,9023253
2022-05-05,NYSE American (A),19478279,35565391,19577322,74620992,857366378.898200,1871437340.597700,1228402827.827000,3957206547.322900,227889,161384,187067,576340
2022-05-05,NASDAQ BX (B),24882271,26392489,30761730,82036490,1268932746.475500,2340236325.768300,2609371098.305801,6218540170.549601,520832,194118,518731,1233681
2022-05-05,NYSE National (C),50271048,49485858,34350847,134107753,1352732635.945000,2226750677.005900,1313158233.107099,4892641546.057999,540000,285019,395008,1220027
2022-05-05,FINRA / Nasdaq TRF Chicago (DB),9863026,4088201,13845321,27796548,416812106.967500,149933800.535700,1034158120.011200,1600904027.514400,52998,17224,76491,146713
2022-05-05,FINRA / NYSE TRF (DN),253082828,167082817,430292909,850458554,9429537580.377404,7460602730.934999,20983075101.188899,37873215412.501302,1496071,436859,1796393,3729323
2022-05-05,FINRA / Nasdaq TRF Carteret (DQ),1435157543,963930990,1850556760,4249645293,64711436853.383297,56777514012.696114,101440335873.853234,222929286739.932645,8043108,2968941,8225309,19237358
2022-05-05,MIAX Pearl (H),42773661,71425405,42389553,156588619,1262698038.923800,4045147899.452001,2771169188.325501,8079015126.701302,469689,327848,458532,1256069
2022-05-05,EDGA Equities (J),76744509,73482259,71855480,222082248,3247570366.959400,4501124056.762900,4715988219.849801,12464682643.572101,1111674,559763,983188,2654625
2022-05-05,EDGX Equities (K),312983189,174878970,312490681,800352840,11982461630.485203,11726029906.167592,19318929137.615298,43027420674.268093,2937091,1029681,2787579,6754351
2022-05-05,LTSE (L),50281,1114,133122,184517,3115231.180000,17632.580000,5044091.930000,8176955.690000,740,15,749,1504
2022-05-05,NYSE Chicago (M),10422294,15547092,13768268,39737654,871429464.803900,2042193938.985700,2572690715.295600,5486314119.085200,95855,4631,63885,164371
2022-05-05,NYSE (N),1079728705,82621095,95395141,1257744941,56671554751.859699,6219667512.424997,6211722955.842801,69102945220.127497,5935197,388668,849173,7173038
2022-05-05,NYSE Arca (P),268321317,577745570,430388402,1276455289,11327546637.188499,40227299612.895106,30023227299.912201,81578073549.995806,2888526,2695161,4366241,9949928
2022-05-05,NASDAQ (Q),661222459,426202785,1270400648,2357825892,32188577888.433210,38444881004.002709,94021465375.556188,164654924267.992107,8993784,3282263,12019891,24295938
2022-05-05,Members Exchange (U),214762668,159144946,185549443,559457057,6080296356.808899,10180947149.455699,8461393021.033496,24722636527.298094,1865365,883078,1665694,4414137
2022-05-05,Investors Exchange (V),190253233,44083223,144853983,379190439,11554389978.494099,4115337904.273502,11821527830.071400,27491255712.839001,2460178,283603,1937244,4681025
2022-05-05,NASDAQ PSX (X),34411857,66682347,40045990,141140194,1248933660.662000,3921220675.412501,2703451872.118100,7873606208.192601,342400,335591,422042,1100033
2022-05-05,BYX Equities (Y),74527001,58904003,55427894,188858898,2287907059.731000,4502039653.430003,3074591125.046700,9864537838.207703,812553,347896,673944,1834393
2022-05-05,BZX Equities (Z),318096968,278046726,266839125,862982819,12458866818.919800,21740399589.141304,20818547704.745510,55017814112.806614,3825240,1804653,3440177,9070070
2022-05-04,NYSE American (A),20044378,38676372,16853102,75573852,863178467.560200,1722969151.578400,1129441217.539900,3715588836.678500,206128,169564,165164,540856
2022-05-04,NASDAQ BX (B),24504775,23995908,28729908,77230591,1244883537.871500,2327530001.288900,2204050847.665500,5776464386.825900,481798,191567,481263,1154628
2022-05-04,NYSE National (C),49974536,46263069,36806077,133043682,1339199144.313100,2205654157.064400,1434910318.980000,4979763620.357500,508564,277954,386929,1173447
2022-05-04,FINRA / Nasdaq TRF Chicago (DB),9218519,3534000,14938753,27691272,418113804.399600,141977899.047200,1114446761.961200,1674538465.408000,46557,14226,78619,139402
2022-05-04,FINRA / NYSE TRF (DN),257358014,152345508,484659164,894362686,9336338290.994205,6418887019.120897,23100125870.625115,38855351180.740217,1419573,360295,1742578,3522446
2022-05-04,FINRA / Nasdaq TRF Carteret (DQ),1526844076,902642632,1974170452,4403657160,67845103491.499303,53738551103.023417,103019696075.656209,224603350670.178929,7657051,2416696,7930344,18004091
2022-05-04,MIAX Pearl (H),38444493,57693446,40220037,136357976,1053958514.339400,3266750269.853700,2499632142.672201,6820340926.865301,385631,267289,391948,1044868
2022-05-04,EDGA Equities (J),78700258,71968058,67840049,218508365,3203105799.134600,4509197258.791701,4126778674.081500,11839081732.007801,1081587,561352,931544,2574483
2022-05-04,EDGX Equities (K),309902183,177267991,320598687,807768861,11292661517.016803,11083688107.680802,18197724664.441906,40574074289.139511,2680117,1015519,2681227,6376863
2022-05-04,LTSE (L),60733,46117,20550,127400,1935811.890000,19043839.980000,1401335.970000,22380987.840000,240,103,270,613
2022-05-04,NYSE Chicago (M),12167986,4430557,13023353,29621896,1118705832.463100,495322527.752800,1959334932.914300,3573363293.130200,114425,4158,87061,205644
2022-05-04,NYSE (N),1088964763,85427916,93691094,1268083773,55881465837.867294,5988237160.221100,5150582560.822096,67020285558.910490,5632058,372511,783031,6787600
2022-05-04,NYSE Arca (P),264629939,543836763,426708330,1235175032,10717082436.692995,37229716518.129987,28226099392.161191,76172898346.984173,2681350,2502310,4218058,9401718
2022-05-04,NASDAQ (Q),648842918,436043294,1270182269,2355068481,30463737162.209502,37477516079.895389,85894429893.537323,153835683135.642214,8407804,3264157,11640563,23312524
2022-05-04,Members Exchange (U),208878834,157574819,192576828,559030481,5983336786.674800,9455588093.826202,8159120155.252005,23598045035.753007,1815279,852872,1655729,4323880
2022-05-04,Investors Exchange (V),193288570,41394603,148504535,383187708,11636559232.429699,3467269800.771001,11462203542.791801,26566032575.992501,2444260,256403,1937582,4638245
2022-05-04,NASDAQ PSX (X),31141924,61089592,34278283,126509799,1045737846.290900,3384431126.338600,2287355780.621199,6717524753.250699,284011,304663,362590,951264
2022-05-04,BYX Equities (Y),66864511,44911946,53731662,165508119,2129817745.687000,3760026889.885900,3049237958.483700,8939082594.056600,750986,280039,656086,1687111
2022-05-04,BZX Equities (Z),306533332,281303844,280526600,868363776,11877977046.108002,22284279324.120505,19430209469.705595,53592465839.934102,3563740,1922996,3378938,8865674
2022-05-03,NYSE American (A),15202650,25935374,11235711,52373735,666105865.936600,1003454498.358100,601938513.083900,2271498877.378600,185398,120728,136409,442535
2022-05-03,NASDAQ BX (B),23353339,17058209,23746794,64158342,1217484244.325900,1378452854.100100,1573013811.444700,4168950909.870700,475244,140216,432709,1048169
2022-05-03,NYSE National (C),44401696,39590283,30474157,114466136,1244622744.439000,1901804572.190600,1083612850.897500,4230040167.527100,498869,231091,359204,1089164
2022-05-03,FINRA / Nasdaq TRF Chicago (DB),8086572,2522323,11586259,22195154,325535314.193200,114849154.208100,829303881.178600,1269688349.579900,40959,10955,64234,116148
2022-05-03,FINRA / NYSE TRF (DN),237978653,136022529,393258081,767259263,8461193181.798700,6206172545.427102,18132804694.493307,32800170421.719109,1325234,313961,1518756,3157951
2022-05-03,FINRA / Nasdaq TRF Carteret (DQ),1367740411,752023256,1684651409,3804415076,59439800962.401114,44783027738.840232,83560960170.528739,187783788871.770085,6979239,2276113,6799036,16054388
2022-05-03,MIAX Pearl (H),36849067,53216833,35548591,125614491,1106424090.109800,2964200673.670400,1938771499.396400,6009396263.176600,404513,247320,347347,999180
2022-05-03,EDGA Equities (J),64853965,49375423,53721627,167951015,2777902088.195600,2983640742.532301,3090333108.456499,8851875939.184400,945021,378053,779617,2102691
2022-05-03,EDGX Equities (K),262674547,117510629,261676251,641861427,9556462622.455699,7274687954.290501,13361875422.698707,30193025999.444907,2363305,690455,2246756,5300516
2022-05-03,LTSE (L),18010,375,24846,43231,1189771.960000,10596.980000,1673669.030000,2874037.970000,269,11,344,624
2022-05-03,NYSE Chicago (M),13744185,8744034,15244542,37732761,969602415.076600,804479565.352800,2412043902.905499,4186125883.334899,74364,3975,60126,138465
2022-05-03,NYSE (N),975752866,58515282,77194071,1111462219,50569290233.494092,4171946988.273200,3830183499.933000,58571420721.700292,5136042,275038,678073,6089153
2022-05-03,NYSE Arca (P),245203565,414705800,367353335,1027262700,9752833179.655400,28139322678.431699,20906651068.261209,58798806926.348308,2511082,1870730,3619780,8001592
2022-05-03,NASDAQ (Q),559984208,307912107,1001178018,1869074333,26835464712.330806,25615249950.693206,61566137653.119005,114016852316.143017,7907670,2308419,10016759,20232848
2022-05-03,Members Exchange (U),193102190,122121194,163834123,479057507,5510240217.541001,7276798694.967702,6200531282.831800,18987570195.340503,1695431,703902,1429390,3828723
2022-05-03,Investors Exchange (V),165407977,33434846,116402998,315245821,9959887960.405900,2537693072.251601,8366574242.709096,20864155275.366597,2221130,211705,1638711,4071546
2022-05-03,NASDAQ PSX (X),26123794,45138603,27477816,98740213,897882836.497800,2282233428.429400,1696365916.989200,4876482181.916400,264368,206428,307394,778190
2022-05-03,BYX Equities (Y),65089820,41770771,47403836,154264427,2011612694.632500,3042038104.508000,2165126677.873300,7218777477.013800,734648,244589,610157,1589394
2022-05-03,BZX Equities (Z),276490650,199736768,225273655,701501073,10652179435.204705,14750949460.521500,13746751119.596898,39149880015.323103,3366245,1307562,2849002,7522809
2022-05-02,NYSE American (A),17204319,34101885,14062810,65369014,746426593.511500,1470985323.116600,853036615.007600,3070448531.635700,200952,157584,151979,510515
2022-05-02,NASDAQ BX (B),23759534,24728501,28825517,77313552,1222049430.944300,2049641601.659200,2384140667.852299,5655831700.455799,472341,184574,475276,1132191
2022-05-02,NYSE National (C),50562006,43529994,34223293,128315293,1394282629.094100,2089075399.832100,1251958002.653500,4735316031.579700,527594,247992,363420,1139006
2022-05-02,FINRA / Nasdaq TRF Chicago (DB),8847575,3858386,15256691,27962652,368666904.480500,169798941.373400,1019184740.421000,1557650586.274900,47003,15320,68414,130737
2022-05-02,FINRA / NYSE TRF (DN),279823252,158391209,390792881,829007342,9316486751.886001,6996078484.237703,18969214622.937292,35281779859.060996,1460603,398644,1675842,3535089
2022-05-02,FINRA / Nasdaq TRF Carteret (DQ),1530762730,985190523,1746503031,4262456284,63680134368.842215,64689899772.002357,94736599249.775866,223106633390.620438,7755322,2969876,7533784,18258982
2022-05-02,MIAX Pearl (H),41434766,60839313,32695734,134969813,1162716199.401900,3282693083.087600,1808975122.046600,6254384404.536100,438477,296200,362786,1097463
2022-05-02,EDGA Equities (J),75296251,69357572,64724509,209378332,3250211912.883900,4347927129.887902,4118261138.319801,11716400181.091603,1068518,537781,909440,2515739
2022-05-02,EDGX Equities (K),291643733,158231336,279725258,729600327,10048418604.410100,10853216452.525598,15536659550.103191,36438294607.038889,2618747,1016444,2490158,6125349
2022-05-02,LTSE (L),9273,9334,18162,36769,735305.990000,3814810.270000,1458379.960000,6008496.220000,123,5,129,257
2022-05-02,NYSE Chicago (M),11757554,8412591,14790796,34960941,1046521947.432700,1839519540.294200,2985826550.735900,5871868038.462800,97419,4266,68153,169838
2022-05-02,NYSE (N),1111329524,90598415,92270879,1294198818,55435709711.403301,6009458396.418202,5191123188.883202,66636291296.704705,6129337,404161,814365,7347863
2022-05-02,NYSE Arca (P),275209354,560984075,392385672,1228579101,10840232517.500701,39062942788.884390,25906939062.204396,75810114368.589487,2816790,2732824,4127115,9676729
2022-05-02,NASDAQ (Q),645235576,427009602,1170048197,2242293375,30718022253.496993,36458431734.763007,78986201379.907101,146162655368.167101,8842790,3321937,11505511,23670238
2022-05-02,Members Exchange (U),216816124,152143708,178656243,547616075,6095915201.334500,9540610168.472399,7265818650.298400,22902344020.105299,1834698,888645,1577202,4300545
2022-05-02,Investors Exchange (V),175831399,41375766,127584134,344791299,10899898079.957003,3688009356.803901,9840757464.401200,24428664901.162104,2303459,263713,1715342,4282514
2022-05-02,NASDAQ PSX (X),31081831,61507563,33400073,125989467,985694043.311800,3677983342.987100,2492179866.927600,7155857253.226500,303383,313050,365735,982168
2022-05-02,BYX Equities (Y),73024328,52833242,52124883,177982453,2086843147.077700,4057850073.133100,2547743274.811800,8692436495.022600,800907,329916,648326,1779149
2022-05-02,BZX Equities (Z),304163546,273245316,250151628,827560490,11794254116.899898,22003772137.363699,16928156445.376104,50726182699.639701,3735382,1910318,3259019,8904719
2022-04-29,NYSE American (A),19783840,38391828,14381483,72557151,878274782.363600,1704033972.277100,1073085080.535600,3655393835.176300,210151,147611,153563,511325
2022-04-29,NASDAQ BX (B),24361665,21373559,25819878,71555102,1228753949.292100,1769999481.080200,2219508066.242601,5218261496.614901,456505,160101,445560,1062166
2022-04-29,NYSE National (C),47155919,42396798,32914735,122467452,1327926280.612500,2010607489.080600,1442259610.720500,4780793380.413600,475979,216743,349620,1042342
2022-04-29,FINRA / Nasdaq TRF Chicago (DB),9868154,3856037,13283058,27007249,375820942.299700,161313824.295200,1035639847.599800,1572774614.194700,47360,14074,71663,133097
2022-04-29,FINRA / NYSE TRF (DN),233276107,136443298,386700049,756419454,8825139029.334498,5409952574.547305,19915342975.138709,34150434579.020512,1378726,359216,1677769,3415711
2022-04-29,FINRA / Nasdaq TRF Carteret (DQ),1408493914,924771518,1640400161,3973665593,65842567632.556394,59118280958.606111,97265562356.707211,222226410947.869716,7340262,2441728,7371649,17153639
2022-04-29,MIAX Pearl (H),39186214,56393316,35896867,131476397,1183629562.225600,3074837333.455699,2376952242.679400,6635419138.360699,410015,252737,362285,1025037
2022-04-29,EDGA Equities (J),68502053,59493547,59234347,187229947,2909635514.903200,3578554178.641901,3607711880.592700,10095901574.137801,970842,437911,817327,2226080
2022-04-29,EDGX Equities (K),274399312,138874517,268873378,682147207,10327418300.985401,9474561865.120298,17281729204.445385,37083709370.551084,2562699,845297,2458951,5866947
2022-04-29,LTSE (L),3435,6143,14473,24051,208199.510000,559663.850000,1934330.410000,2702193.770000,33,64,83,180
2022-04-29,NYSE Chicago (M),16432068,8594599,9371266,34397933,906452485.086200,1175958543.981100,1907550298.111200,3989961327.178500,66463,3576,49822,119861
2022-04-29,NYSE (N),1376030591,69256527,77387596,1522674714,75115577019.851204,5072498095.665301,4598838919.619201,84786914035.135706,5232601,318425,689419,6240445
2022-04-29,NYSE Arca (P),248894015,485889467,366245828,1101029310,10654938583.734699,34214444077.079102,26788118520.476898,71657501181.290699,2576602,2240711,3852839,8670152
2022-04-29,NASDAQ (Q),586115258,362158268,1212920827,2161194353,28006856788.823897,31346944987.233613,89657517174.447812,149011318950.505322,7507795,2580134,10192196,20280125
2022-04-29,Members Exchange (U),184081007,122759172,152677810,459517989,5195541932.432300,7960319934.989501,6764511915.269203,19920373782.691004,1501989,674039,1337822,3513850
2022-04-29,Investors Exchange (V),167105128,38456691,124745085,330306904,10285297689.445103,3481751236.759500,10871652294.618705,24638701220.823308,2180591,242563,1687662,4110816
2022-04-29,NASDAQ PSX (X),29709998,53528151,31922851,115161000,1022739440.755800,2975100536.134500,2094684136.283100,6092524113.173400,274238,250400,322453,847091
2022-04-29,BYX Equities (Y),72601031,54671823,50669904,177942758,2113842204.691100,3855909407.367801,2864712616.343099,8834464228.402000,750975,304247,609700,1664922
2022-04-29,BZX Equities (Z),278030692,225673853,229616630,733321175,11274427677.783502,17528962256.972604,17073738799.959798,45877128734.715904,3343259,1427354,2860504,7631117
2022-04-28,NYSE American (A),18937027,34029634,14178489,67145150,895178687.301300,1297090569.518100,921183004.451600,3113452261.271000,210410,141594,156969,508973
2022-04-28,NASDAQ BX (B),26348336,18871302,25433540,70653178,1321448855.886400,1684002248.567900,2163570149.778899,5169021254.233199,476718,141901,469631,1088250
2022-04-28,NYSE National (C),50321788,40620037,34688127,125629952,1532470622.907900,1892059170.981600,1432569715.660500,4857099509.550000,547611,226748,381170,1155529
2022-04-28,FINRA / Nasdaq TRF Chicago (DB),9492458,3258074,12769806,25520338,375916627.585500,166775880.430300,1146988461.712500,1689680969.728300,47644,12715,77205,137564
2022-04-28,FINRA / NYSE TRF (DN),248248199,154410336,447883114,850541649,9283594221.193398,5990903494.753099,21386605898.857304,36661103614.803801,1403595,335877,1715602,3455074
2022-04-28,FINRA / Nasdaq TRF Carteret (DQ),1484687068,895054874,1842028225,4221770167,67542192579.980738,48145634506.023898,101188430479.210058,216876257565.214694,7802409,2276117,7733088,17811614
2022-04-28,MIAX Pearl (H),36718589,57127715,43006093,136852397,1202566641.830000,2957690502.342600,2651836281.347498,6812093425.520098,411265,248104,393665,1053034
2022-04-28,EDGA Equities (J),72727350,51634662,62075088,186437100,3251517860.373900,2909705878.375601,3942400539.556598,10103624278.306099,1022531,389555,859303,2271389
2022-04-28,EDGX Equities (K),290145393,128502530,308520030,727167953,11068872184.366405,7560459287.644896,18560338437.803197,37189669909.814498,2665268,718120,2604382,5987770
2022-04-28,LTSE (L),2434,64,68311,70809,233666.530000,2432.000000,9672811.370000,9908909.900000,25,1,328,354
2022-04-28,NYSE Chicago (M),13584117,7827202,12780421,34191740,983240384.318800,789306009.203200,3124012625.382401,4896559018.904401,78586,3495,61294,143375
2022-04-28,NYSE (N),1008456192,62881739,80810395,1152148326,52209266445.672089,4527427397.613700,4616997097.475499,61353690940.761288,5062643,279728,709850,6052221
2022-04-28,NYSE Arca (P),251639124,455475325,427796132,1134910581,10728173520.638897,29807806238.462471,32239518840.537317,72775498599.638685,2586881,1983571,4215040,8785492
2022-04-28,NASDAQ (Q),588176734,330836669,1130911618,2049925021,29100312246.583902,26209647985.703009,80356562780.356450,135666523012.643361,7693612,2362431,10482172,20538215
2022-04-28,Members Exchange (U),186144740,111458667,163035041,460638448,5418310571.507700,6484878118.929699,6914293200.404302,18817481890.841701,1561351,600551,1396634,3558536
2022-04-28,Investors Exchange (V),180571470,34430208,129808297,344809975,11357587805.899099,3019831621.351100,11245294923.860997,25622714351.111196,2368585,223121,1813481,4405187
2022-04-28,NASDAQ PSX (X),28441968,53761897,29770535,111974400,1011835718.980800,2938024032.706800,1936748378.918300,5886608130.605900,288190,236577,328114,852881
2022-04-28,BYX Equities (Y),71745135,43722777,52667989,168135901,2155773105.397400,3028431776.691900,2847921120.444501,8032126002.533801,747649,250170,632187,1630006
2022-04-28,BZX Equities (Z),287800925,203513575,248923535,740238035,11559027540.563600,15272754818.833500,17599573441.537188,44431355800.934288,3475516,1318511,3073211,7867238
2022-04-27,NYSE American (A),16466652,31034330,12257051,59758033,722834381.118600,1139478814.704000,797784177.932700,2660097373.755300,185854,141846,135400,463100
2022-04-27,NASDAQ BX (B),24159276,22213202,26152855,72525333,1319125097.154600,1816516050.819201,2340031875.393600,5475673023.367401,479791,177353,468337,1125481
2022-04-27,NYSE National (C),46297485,42072280,30294968,118664733,1325083956.972300,1903948216.582200,1318152719.212500,4547184892.767000,473058,219621,334394,1027073
2022-04-27,FINRA / Nasdaq TRF Chicago (DB),7968369,3552212,11991937,23512518,334777145.589300,166541784.275700,838396366.459100,1339715296.324100,42451,13445,69863,125759
2022-04-27,FINRA / NYSE TRF (DN),226254190,142558553,416103354,784916097,9146038140.886298,6226207507.102201,18875360680.080800,34247606328.069299,1347648,327230,1607912,3282790
2022-04-27,FINRA / Nasdaq TRF Carteret (DQ),1455332126,919777014,1755016744,4130125884,66373520155.998584,55983986466.041547,92074864083.316483,214432370705.356614,7236098,2364705,7198673,16799476
2022-04-27,MIAX Pearl (H),51713925,81294025,44647931,177655881,1437089460.761400,4263297983.029101,2981155303.700201,8681542747.490702,517583,382090,460087,1359760
2022-04-27,EDGA Equities (J),72046381,62503733,60427036,194977150,3222464186.821500,3760299089.348801,4026938531.402200,11009701807.572501,1030102,474387,872402,2376891
2022-04-27,EDGX Equities (K),266033886,137080821,275736869,678851576,10592475655.478403,8708333674.789497,15850577903.034898,35151387233.302798,2542294,825552,2431402,5799248
2022-04-27,LTSE (L),78408,393,143703,222504,2830885.790000,19950.590000,19977758.606900,22828594.986900,46,5,806,857
2022-04-27,NYSE Chicago (M),11917261,5372109,12006495,29295865,926056550.034200,912480908.826500,2100753411.904700,3939290870.765400,82602,3425,59329,145356
2022-04-27,NYSE (N),992997340,72828807,80363806,1146189953,52009817018.280802,5418925624.277201,4640313933.544002,62069056576.102005,5297444,345956,722598,6365998
2022-04-27,NYSE Arca (P),242797325,501271828,397323311,1141392464,10276773214.545108,33215854427.899904,27733505204.090789,71226132846.535801,2524098,2281719,4004069,8809886
2022-04-27,NASDAQ (Q),601107726,389481793,1072320516,2062910035,29872692510.988400,30464719393.585804,77152498485.343944,137489910389.918148,8174694,2873751,10727300,21775745
2022-04-27,Members Exchange (U),184876779,130657500,169403042,484937321,5237246171.793799,8108698753.874499,7166387462.306196,20512332387.974494,1537773,718508,1445424,3701705
2022-04-27,Investors Exchange (V),173244238,38746992,121767647,333758877,11105990992.932597,2883806009.707100,10546704442.029900,24536501444.669597,2327755,244330,1788826,4360911
2022-04-27,NASDAQ PSX (X),30048579,62568585,32773512,125390676,1069543022.904400,3457861927.257401,2570948687.675299,7098353637.837100,309692,305014,369400,984106
2022-04-27,BYX Equities (Y),71318250,49509914,49953521,170781685,2261027764.160200,3507002078.297999,2873174137.204400,8641203979.662599,785158,281641,636192,1702991
2022-04-27,BZX Equities (Z),295024156,250845697,242039005,787908858,11975625993.695402,18981542439.901493,17130189152.872502,48087357586.469397,3693295,1717254,3195866,8606415
2022-04-26,NYSE American (A),18710687,35171385,15941975,69824047,813878463.054200,1614818203.782200,974893052.692000,3403589719.528400,207464,154773,158855,521092
2022-04-26,NASDAQ BX (B),23462732,19161538,26219222,68843492,1205578365.484500,1576239452.252300,2188373205.914800,4970191023.651600,450135,169936,438459,1058530
2022-04-26,NYSE National (C),47546271,42054695,33121156,122722122,1274687681.170300,1874823714.488600,1376546294.794700,4526057690.453600,471788,236953,355129,1063870
2022-04-26,FINRA / Nasdaq TRF Chicago (DB),8723449,3591145,13367039,25681633,376033333.273500,167593179.656900,965564705.880000,1509191218.810400,46204,15496,78431,140131
2022-04-26,FINRA / NYSE TRF (DN),230539838,153976413,481060563,865576814,9341809556.948701,6024159649.553597,19619961531.192094,34985930737.694392,1469837,397514,1812426,3679777
2022-04-26,FINRA / Nasdaq TRF Carteret (DQ),1466959570,935473887,1917200583,4319634040,67009983382.638417,50693075215.713786,94900561460.636292,212603620058.988495,7491330,2783507,7855856,18130693
2022-04-26,MIAX Pearl (H),45227442,63684400,40465553,149377395,1352417634.803200,3199060278.504500,2648376409.391201,7199854322.698901,496571,306639,429278,1232488
2022-04-26,EDGA Equities (J),69599837,54891883,64583762,189075482,2925541943.118600,3444052523.531500,4015307747.586899,10384902214.236999,989399,421855,867809,2279063
2022-04-26,EDGX Equities (K),253676094,134234525,305107124,693017743,9694346829.202703,7907037580.310302,16566788044.653395,34168172454.166400,2441487,805586,2521701,5768774
2022-04-26,LTSE (L),13130,312,210154,223596,1612127.570000,6691.050000,8028859.530000,9647678.150000,44,7,195,246
2022-04-26,NYSE Chicago (M),9867299,9071568,9847418,28786285,843486908.342100,753497222.548200,1644382565.089300,3241366695.979600,72056,4425,53144,129625
2022-04-26,NYSE (N),1000824089,77360289,84588696,1162773074,51573178310.863096,5328591884.900198,4691326501.867399,61593096697.630693,4930790,352341,694096,5977227
2022-04-26,NYSE Arca (P),230385685,465975694,413118797,1109480176,9777038634.592703,31593436436.589420,29420250438.604295,70790725509.786418,2451945,2205444,4084084,8741473
2022-04-26,NASDAQ (Q),572400876,343621030,1141511519,2057533425,28566891176.915592,29114881932.986418,78919632884.778417,136601405994.680427,7792581,2628153,10354611,20775345
2022-04-26,Members Exchange (U),180786810,123177597,177788001,481752408,5126653348.967700,7088926084.813204,6640275096.337703,18855854530.118607,1524712,653267,1402529,3580508
2022-04-26,Investors Exchange (V),161609660,37506177,119119397,318235234,10053298896.531199,3226635435.046598,9551072480.682000,22831006812.259797,2145180,251001,1649030,4045211
2022-04-26,NASDAQ PSX (X),26685951,50175987,31414032,108275970,938096865.651100,2858825876.444600,2275162821.430300,6072085563.526000,283289,250656,326676,860621
2022-04-26,BYX Equities (Y),72010909,49876306,53666161,175553376,2067131772.633500,3307333797.844299,2715488426.902799,8089953997.380598,757478,294159,617594,1669231
2022-04-26,BZX Equities (Z),270939976,210430555,239832139,721202670,11050497260.731496,15514178804.322494,17124340168.088190,43689016233.142180,3446466,1454155,3089489,7990110
2022-04-25,NYSE American (A),21393368,36320340,14188877,71902585,832266469.348600,1360350217.298300,824742583.100200,3017359269.747100,221629,157949,145615,525193
2022-04-25,NASDAQ BX (B),27120724,23927217,28078228,79126169,1322797758.040000,2088049401.667801,2211913387.036101,5622760546.743902,509186,197029,469743,1175958
2022-04-25,NYSE National (C),51980355,48200560,33402679,133583594,1360624784.472500,2034133374.046100,1183300592.017900,4578058750.536500,511604,246852,349873,1108329
2022-04-25,FINRA / Nasdaq TRF Chicago (DB),10646535,4959780,12514013,28120328,413862672.954700,239619895.745400,882729066.493900,1536211635.194000,55596,20508,69584,145688
2022-04-25,FINRA / NYSE TRF (DN),257789488,155135433,419076308,832001229,10689391357.728709,6277186755.520101,18415924937.425206,35382503050.674016,1689060,418530,1698543,3806133
2022-04-25,FINRA / Nasdaq TRF Carteret (DQ),1607948427,973585279,1762472817,4344006523,73780323264.586266,55050309000.600505,87921269659.359127,216751901924.545898,8291260,3255076,7345932,18892268
2022-04-25,MIAX Pearl (H),55179309,74661113,39519293,169359715,1564520768.740700,3611252361.762300,2512470187.064700,7688243317.567700,555978,361977,449002,1366957
2022-04-25,EDGA Equities (J),74337960,64644090,59697030,198679080,3141822852.012300,3593275721.369699,3792070561.668299,10527169135.050298,1035894,480159,826340,2342393
2022-04-25,EDGX Equities (K),297182037,154714759,281543488,733440284,11221034307.778896,9736015285.264400,15177771669.664515,36134821262.707811,2638842,919202,2421404,5979448
2022-04-25,LTSE (L),131282,58542,6074,195898,5660322.440000,5602415.780000,361199.130000,11623937.350000,231,593,68,892
2022-04-25,NYSE Chicago (M),9892236,11950935,10719739,32562910,829471150.316000,1890364446.440700,2081391738.422100,4801227335.178800,75135,5121,53165,133421
2022-04-25,NYSE (N),1099558897,70561263,79607498,1249727658,56098628533.465290,4689276842.203499,4312337810.209302,65100243185.878091,5514425,332298,685015,6531738
2022-04-25,NYSE Arca (P),268077777,532322210,380541630,1180941617,11259104040.310697,34233301736.916593,22658977131.042215,68151382908.269505,2754268,2390953,3919412,9064633
2022-04-25,NASDAQ (Q),666193461,400248469,1124597453,2191039383,32651598104.974101,32406929029.096695,74309166355.552591,139367693489.623387,8758330,2965640,10705228,22429198
2022-04-25,Members Exchange (U),208828599,137127735,163478077,509434411,6035721882.453801,8070975712.627903,6614429404.920800,20721127000.002504,1677832,698832,1389270,3765934
2022-04-25,Investors Exchange (V),171988687,43745296,117770725,333504708,10665988135.686701,3313414961.988600,8667149745.376197,22646552843.051498,2297435,286806,1650931,4235172
2022-04-25,NASDAQ PSX (X),33269471,64265277,33766489,131301237,1120086607.510800,3487519649.821200,2550192895.815899,7157799153.147899,318897,322049,361238,1002184
2022-04-25,BYX Equities (Y),73021712,55593967,48855759,177471438,2130460475.061300,3624815690.397500,2275777844.127699,8031054009.586499,777051,320512,588761,1686324
2022-04-25,BZX Equities (Z),305508329,243099564,235326570,783934463,12167119348.166500,17347408408.133602,15700110817.849201,45214638574.149303,3620748,1663301,3138109,8422158
2022-04-22,NYSE American (A),19119297,33658814,14476516,67254627,833325177.695200,1342775739.589500,839771944.469300,3015872861.754000,206518,143650,140711,490879
2022-04-22,NASDAQ BX (B),22059468,21623359,24850258,68533085,1135981284.952000,1874122981.355700,1849058956.491899,4859163222.799599,428834,167043,417208,1013085
2022-04-22,NYSE National (C),44631436,40359860,30061569,115052865,1299128897.517500,1859715607.502900,1095427420.400800,4254271925.421200,491723,222043,351933,1065699
2022-04-22,FINRA / Nasdaq TRF Chicago (DB),10113775,4523602,11549496,26186873,432038576.846800,189537200.626000,926541626.628900,1548117404.101700,54435,18530,67856,140821
2022-04-22,FINRA / NYSE TRF (DN),237807369,173496343,387088294,798392006,9430124712.039401,6593856774.194696,16727517842.374294,32751499328.608391,1424912,418303,1618032,3461247
2022-04-22,FINRA / Nasdaq TRF Carteret (DQ),1472569269,878182216,1642599164,3993350649,67292630340.806125,54017951176.751714,82995163063.085025,204305744580.642864,7541524,2969253,7150720,17661497
2022-04-22,MIAX Pearl (H),46970422,61298100,37841012,146109534,1372929117.864900,3193967884.557200,2615461960.903700,7182358963.325800,488570,323488,426108,1238166
2022-04-22,EDGA Equities (J),65161632,54649973,53072445,172884050,2827999801.821200,3093734050.387501,3036068108.951198,8957801961.159899,962206,387396,761377,2110979
2022-04-22,EDGX Equities (K),261759963,142278547,258120701,662159211,9990812050.376101,7856812158.798505,14648053516.793415,32495677725.968021,2436228,829559,2268088,5533875
2022-04-22,LTSE (L),15399,18115,41687,75201,1959991.680000,1905389.480000,607211.630000,4472592.790000,98,90,135,323
2022-04-22,NYSE Chicago (M),18218288,6447869,10585818,35251975,1493608410.634800,532775798.224600,1730435727.544500,3756819936.403900,63292,4923,50866,119081
2022-04-22,NYSE (N),1000372558,59294632,67637240,1127304430,53256318396.235105,4339766336.020101,3452220348.381099,61048305080.636305,4645189,278216,587999,5511404
2022-04-22,NYSE Arca (P),217327816,459121152,322156614,998605582,9559733013.475000,30692068052.736405,19939506228.297605,60191307294.509010,2364299,2139746,3445800,7949845
2022-04-22,NASDAQ (Q),565511782,331148236,1075443685,1972103703,27980162980.310117,28950198299.660392,73990213474.753215,130920574754.723724,7562370,2505985,9684729,19753084
2022-04-22,Members Exchange (U),171929949,118266641,147164990,437361580,4982548384.619301,7452185272.723101,5934113647.337598,18368847304.680000,1463045,620007,1241711,3324763
2022-04-22,Investors Exchange (V),152169286,37413900,108159022,297742208,9584096283.514298,2935942292.979999,8633188623.388001,21153227199.882298,2043768,235586,1501583,3780937
2022-04-22,NASDAQ PSX (X),25702586,48869782,26488017,101060385,880704329.446900,2906229765.057099,1867029952.096701,5653964046.600700,264057,238839,302538,805434
2022-04-22,BYX Equities (Y),63928709,53490970,46970039,164389718,1922302472.506300,3386684497.515301,2280161179.358500,7589148149.380101,708518,286372,567996,1562886
2022-04-22,BZX Equities (Z),256576226,207586348,210792353,674954927,10512979017.622798,15452168160.179300,15021665776.246105,40986812954.048203,3216222,1425354,2777909,7419485
2022-04-21,NYSE American (A),15256798,34001404,13506888,62765090,666820066.312000,1126677565.769500,763100103.998800,2556597736.080300,176785,138643,135461,450889
2022-04-21,NASDAQ BX (B),21122594,19134948,26141406,66398948,1127946134.744300,1763349009.458800,2118007048.113699,5009302192.316799,411620,159547,441594,1012761
2022-04-21,NYSE National (C),42084933,36911356,31018327,110014616,1144312958.582300,1741865258.652600,1043981080.692100,3930159297.927000,437367,200153,325973,963493
2022-04-21,FINRA / Nasdaq TRF Chicago (DB),11769446,4130199,15729274,31628919,520776737.049700,195773373.989200,1146287297.820600,1862837408.859500,54943,15499,79150,149592
2022-04-21,FINRA / NYSE TRF (DN),246983745,154025302,508661816,909670863,10530185258.319995,5217806205.631200,19826177311.311894,35574168775.263089,1468450,368407,1902464,3739321
2022-04-21,FINRA / Nasdaq TRF Carteret (DQ),1523731636,892155200,1999437337,4415324173,70276081816.929588,45725508144.885089,93975414335.602580,209977004297.417257,7443908,2469983,7773822,17687713
2022-04-21,MIAX Pearl (H),38700186,48599229,38080433,125379848,1217747859.091300,2775103617.806200,2392130858.967100,6384982335.864600,438021,254657,431474,1124152
2022-04-21,EDGA Equities (J),64259261,48949684,60211415,173420360,2930804651.659700,2721270215.931100,3418358749.944002,9070433617.534802,958446,345393,821916,2125755
2022-04-21,EDGX Equities (K),279178633,132158970,331931176,743268779,11312265904.849900,6986113479.912999,16431289233.044904,34729668617.807803,2571191,719514,2610362,5901067
2022-04-21,LTSE (L),4612,53399,19836,77847,881516.780000,8705239.050000,591964.910000,10178720.740000,83,33,78,194
2022-04-21,NYSE Chicago (M),10348999,9561067,8727552,28637618,929729786.462700,919449476.506800,1129936216.400500,2979115479.370000,60053,3757,48099,111909
2022-04-21,NYSE (N),956553467,56907341,72593821,1086054629,52010951188.452498,4205815509.594298,3818697624.898501,60035464322.945297,4650539,261318,643825,5555682
2022-04-21,NYSE Arca (P),222638983,435411372,394340010,1052390365,9846505486.401702,27476939312.030719,23445166012.352996,60768610810.785417,2412534,1909843,3845775,8168152
2022-04-21,NASDAQ (Q),544802253,300022945,1114546260,1959371458,28093020922.547404,24602935055.321400,75573845118.903091,128269801096.771895,7525785,2239278,10231280,19996343
2022-04-21,Members Exchange (U),166306604,108605243,173250700,448162547,5107441118.651799,6029899029.389201,6293161167.687697,17430501315.728697,1452773,544881,1362919,3360573
2022-04-21,Investors Exchange (V),158155730,32818744,123181623,314156097,10146962369.847799,2458181923.558600,9431907734.279201,22037052027.685600,2038109,212596,1600917,3851622
2022-04-21,NASDAQ PSX (X),24320282,44845681,31254900,100420863,905748503.269300,2604970845.809100,2332384257.181699,5843103606.260099,268170,215531,338132,821833
2022-04-21,BYX Equities (Y),59946057,46105257,54185085,160236399,1902350137.707600,3128997408.302501,2399248837.586100,7430596383.596201,688934,258264,593360,1540558
2022-04-21,BZX Equities (Z),250730596,187241490,236297138,674269224,10814050793.283896,13147653856.245693,15256300476.022105,39218005125.551694,3250412,1263190,2934407,7448009
2022-04-20,NYSE American (A),13399760,25912102,11475731,50787593,603820436.742300,790589274.768800,664685481.133500,2059095192.644600,159053,115420,123770,398243
2022-04-20,NASDAQ BX (B),19409388,16388275,23993391,59791054,1062877902.764900,1563074272.363800,2088155080.354101,4714107255.482801,410697,131029,451417,993143
2022-04-20,NYSE National (C),35980976,30681104,26767928,93430008,1047062652.631100,1441918897.886300,1036643085.159200,3525624635.676600,403279,174914,310138,888331
2022-04-20,FINRA / Nasdaq TRF Chicago (DB),9606211,3232265,12900906,25739382,367309101.495200,142603042.083600,994279174.196800,1504191317.775600,46152,12557,75723,134432
2022-04-20,FINRA / NYSE TRF (DN),246823168,135464654,466113670,848401492,10234915069.470124,4521352532.415303,18414134770.193894,33170402372.079321,1384030,310955,1758485,3453470
2022-04-20,FINRA / Nasdaq TRF Carteret (DQ),1470399989,697009645,1817079605,3984489239,67148567565.058497,35861701745.990261,85540499465.866077,188550768776.914835,6801033,2018554,7189221,16008808
2022-04-20,MIAX Pearl (H),41322323,42126438,40471255,123920016,1224298561.341900,2459504122.866599,2029120035.853400,5712922720.061899,417790,224285,402131,1044206
2022-04-20,EDGA Equities (J),60120447,39136426,49553682,148810555,2717512245.533100,2257097787.941900,3012759149.653699,7987369183.128699,883949,286114,719034,1889097
2022-04-20,EDGX Equities (K),245646587,106907656,281642832,634197075,9886677915.807004,5653589126.056199,14779428995.142300,30319696037.005503,2260520,575012,2297474,5133006
2022-04-20,LTSE (L),8420,1320,24284,34024,1633428.020000,26697.600000,2334413.310000,3994538.930000,100,14,127,241
2022-04-20,NYSE Chicago (M),8496613,8619378,8674351,25790342,789394500.869700,826710062.525100,1605177831.270300,3221282394.665100,45962,3493,37787,87242
2022-04-20,NYSE (N),851841067,44442897,67147351,963431315,47298962416.445291,3501515895.833498,3767151215.749000,54567629528.027789,4167083,207607,612278,4986968
2022-04-20,NYSE Arca (P),210848640,352019751,356921715,919790106,8888743412.463600,22506224060.938500,22964685324.090598,54359652797.492698,2206984,1531166,3516006,7254156
2022-04-20,NASDAQ (Q),485173669,246953569,971577395,1703704633,25631675935.816189,20396875708.438390,67853330237.644160,113881881881.898739,6790810,1808876,9242820,17842506
2022-04-20,Members Exchange (U),150196156,87974299,155915107,394085562,4788818536.980700,5200649359.071800,5836028396.176798,15825496292.229298,1366173,460062,1243007,3069242
2022-04-20,Investors Exchange (V),143207009,26348361,113773628,283328998,9315700986.431001,1968062694.993000,9247351097.267195,20531114778.691196,1951413,181259,1577017,3709689
2022-04-20,NASDAQ PSX (X),20396826,38589196,26677976,85663998,733293203.578100,2441479908.321000,1850193785.744000,5024966897.643100,226042,177092,290718,693852
2022-04-20,BYX Equities (Y),57614921,36699584,47764598,142079103,1807210539.544200,2534971008.635299,2409563224.974899,6751744773.154398,666138,213595,575224,1454957
2022-04-20,BZX Equities (Z),219958087,156786718,200458921,577203726,9782526960.137200,10903780876.390906,12867490681.101504,33553798517.629610,2975439,1000030,2614405,6589874
2022-04-19,NYSE American (A),13966285,28904226,11362260,54232771,636911834.243500,1034897841.487800,694085161.324600,2365894837.055900,162215,115509,120557,398281
2022-04-19,NASDAQ BX (B),19025904,15596006,20881056,55502966,992742017.062700,1491181069.486100,1342394966.832399,3826318053.381199,370141,126933,357492,854566
2022-04-19,NYSE National (C),36085621,29562977,25479301,91127899,1049008596.517200,1436968436.230600,870035717.470900,3356012750.218700,401897,186379,296028,884304
2022-04-19,FINRA / Nasdaq TRF Chicago (DB),8558660,3321028,11422603,23302291,409369993.246900,137307231.141000,649224339.415600,1195901563.803500,44791,11984,56262,113037
2022-04-19,FINRA / NYSE TRF (DN),223545201,135528363,466560008,825633572,10158759730.461200,4839515020.279000,15456097466.572402,30454372217.312602,1298059,313682,1472504,3084245
2022-04-19,FINRA / Nasdaq TRF Carteret (DQ),1381850121,731627197,1810308730,3923786048,65128833789.574207,41450995433.722383,72652166679.440854,179231995902.737444,6674508,2220090,6354412,15249010
2022-04-19,MIAX Pearl (H),41218119,38341212,32064601,111623932,1206960395.511100,2176740106.109200,1817544015.083700,5201244516.704000,411935,208881,340342,961158
2022-04-19,EDGA Equities (J),57936652,37742216,48072283,143751151,2585257826.398600,2172181929.737000,2464177582.808300,7221617338.943900,846824,282824,664647,1794295
2022-04-19,EDGX Equities (K),226918343,100758068,275083877,602760288,9519612281.032198,5241809379.505001,11908640172.555498,26670061833.092697,2101819,533287,1976519,4611625
2022-04-19,LTSE (L),8010,169700,24662,202372,1163250.940000,12266889.000000,2699029.810000,16129169.750000,91,54,247,392
2022-04-19,NYSE Chicago (M),10976668,11128819,10761002,32866489,1076124428.007900,1613398720.686500,1615701292.455701,4305224441.150101,40971,4254,33362,78587
2022-04-19,NYSE (N),856370665,43435028,63206992,963012685,46795513418.263499,3505927101.556900,2977416560.529900,53278857080.350299,3945356,205864,537553,4688773
2022-04-19,NYSE Arca (P),190366385,338850714,334859657,864076756,8964300403.098606,22317421781.568292,18962310899.331000,50244033083.997898,2089104,1442737,3186122,6717963
2022-04-19,NASDAQ (Q),461796865,223414707,940388606,1625600178,23734645332.073898,19412633868.045799,59026037396.262636,102173316596.382333,6270171,1683306,8048372,16001849
2022-04-19,Members Exchange (U),148951391,83129548,150051023,382131962,4620579131.784300,4950533848.329201,5143655775.926999,14714768756.040500,1307804,432946,1148017,2888767
2022-04-19,Investors Exchange (V),136323505,28079922,104044919,268448346,8391137899.697499,2221667988.360000,7095901591.925400,17708707479.982899,1753726,191467,1397725,3342918
2022-04-19,NASDAQ PSX (X),20323718,35107063,25682143,81112924,693976542.655200,2427451938.882502,1406329334.306200,4527757815.843902,221415,178434,251053,650902
2022-04-19,BYX Equities (Y),57424500,37807344,46667078,141898922,1764305500.267800,2763740934.910400,1926512030.192300,6454558465.370500,641178,217985,514815,1373978
2022-04-19,BZX Equities (Z),216479574,132811800,185921084,535212458,9255330938.380398,9821525462.897805,10686208577.956503,29763064979.234706,2821309,891030,2329977,6042316
2022-04-18,NYSE American (A),13285439,34671561,10796258,58753258,556560991.358100,780371841.765000,521347000.626300,1858279833.749400,160210,131727,122078,414015
2022-04-18,NASDAQ BX (B),17016368,15212609,23420318,55649295,895485979.662100,1215023570.609300,1579193718.890100,3689703269.161500,347892,122478,375933,846303
2022-04-18,NYSE National (C),32685581,29797443,22698896,85181920,894973860.941000,1323952988.251600,721329563.370600,2940256412.563200,354906,181048,269457,805411
2022-04-18,FINRA / Nasdaq TRF Chicago (DB),9586101,4853814,12462505,26902420,352956579.120200,170177400.509400,657514539.458200,1180648519.087800,46204,17197,60800,124201
2022-04-18,FINRA / NYSE TRF (DN),234947951,185329795,436274197,856551943,9285506766.701888,4731588334.870802,15165363908.589407,29182459010.162097,1361011,383708,1516808,3261527
2022-04-18,FINRA / Nasdaq TRF Carteret (DQ),1290316692,839852848,1693226597,3823396137,56178923359.273491,37408801545.114803,66830086748.220501,160417811652.608795,6488810,2657062,6360999,15506871
2022-04-18,MIAX Pearl (H),48771666,39248261,31378580,119398507,1116572816.293100,1987152397.739900,1552570795.936699,4656296009.969699,389067,214294,329830,933191
2022-04-18,EDGA Equities (J),50725775,35472502,44929378,131127655,2107781594.069400,1876304635.041700,2230598023.211900,6214684252.323000,745199,262771,631861,1639831
2022-04-18,EDGX Equities (K),230247730,128549896,271721806,630519432,8701861438.471999,5191313758.094799,11068103076.031401,24961278272.598199,2037225,614303,1965994,4617522
2022-04-18,LTSE (L),19140,9300,11435,39875,1299021.110000,2373574.000000,2308950.520000,5981545.630000,135,5,107,247
2022-04-18,NYSE Chicago (M),10737894,11694664,10703531,33136089,1099718028.028600,1285811615.364000,1985689452.302699,4371219095.695299,44273,5278,37485,87036
2022-04-18,NYSE (N),828459606,47102144,62986379,938548129,42915585081.800703,3378652724.039300,2665331133.044500,48959568938.884503,3718333,212485,511323,4442141
2022-04-18,NYSE Arca (P),176074161,354885630,327015801,857975592,7588182746.506002,21270382832.729999,15511705184.075091,44370270763.311092,1920107,1541302,3002037,6463446
2022-04-18,NASDAQ (Q),418679828,227903969,920254469,1566838266,20223127346.925395,17634630023.077296,52346142504.664482,90203899874.667173,5745435,1712334,7957693,15415462
2022-04-18,Members Exchange (U),148930994,89380462,148528609,386840065,4116114949.419900,4510430817.933999,4660027691.844801,13286573459.198700,1247118,454516,1135698,2837332
2022-04-18,Investors Exchange (V),124249214,27805597,97775198,249830009,7458537904.337299,1911891964.454000,6053976932.625000,15424406801.416299,1644705,193973,1312159,3150837
2022-04-18,NASDAQ PSX (X),21686717,35779515,22114795,79581027,658521824.485200,1954878035.818600,1299999488.520500,3913399348.824300,208788,170994,238378,618160
2022-04-18,BYX Equities (Y),51491946,36746565,42852032,131090543,1428630392.126400,2348459937.510999,1703865598.124000,5480955927.761399,564177,214463,493268,1271908
2022-04-18,BZX Equities (Z),202577350,137809519,186082981,526469850,8094857418.602899,9772683725.003398,10320240711.720002,28187781855.326299,2630342,958781,2329764,5918887
2022-04-14,NYSE American (A),12976345,32881691,10446028,56304064,616121581.183700,1067138757.718900,675192688.362400,2358453027.265000,153464,118058,115674,387196
2022-04-14,NASDAQ BX (B),18916153,15254043,22582450,56752646,1019422652.106300,1540928279.335600,1679142549.212401,4239493480.654301,376138,134795,386692,897625
2022-04-14,NYSE National (C),32617623,30953678,23785483,87356784,1045192729.126800,1479522643.554300,940981218.115000,3465696590.796100,378428,201933,277327,857688
2022-04-14,FINRA / Nasdaq TRF Chicago (DB),7902695,3382560,11388196,22673451,348610729.045700,145794465.103100,658035793.597200,1152440987.746000,43812,12949,56822,113583
2022-04-14,FINRA / NYSE TRF (DN),219090479,132245280,471193130,822528889,9226289145.920602,5247542045.770001,14720423824.486696,29194255016.177299,1308861,305456,1438551,3052868
2022-04-14,FINRA / Nasdaq TRF Carteret (DQ),1325494369,685171047,1776282899,3786948315,64374634420.299109,44677989593.565969,72171932607.458030,181224556621.323108,6636117,2149369,6323024,15108510
2022-04-14,MIAX Pearl (H),37537625,37194650,34105215,108837490,1268954868.533000,2229673733.873700,1821031576.965100,5319660179.371800,421745,204471,351286,977502
2022-04-14,EDGA Equities (J),55085839,37177484,49048478,141311801,2504974141.114100,2310063930.483400,2525990666.678900,7341028738.276400,804143,284648,640230,1729021
2022-04-14,EDGX Equities (K),230384837,101458330,282805800,614648967,9911883072.564002,5639800557.035999,11886667136.974007,27438350766.574008,2081288,575075,2003979,4660342
2022-04-14,LTSE (L),9018,3133,34946,47097,1695428.530000,54179.860000,1496846.050000,3246454.440000,131,29,95,255
2022-04-14,NYSE Chicago (M),15370018,15178845,13137124,43685987,1349863447.937500,1892203424.515100,3194573308.404800,6436640180.857400,50143,4312,40665,95120
2022-04-14,NYSE (N),919838983,44138203,61512933,1025490119,55037855437.841198,3489754810.177900,3073126591.238199,61600736839.257297,3936061,206635,522488,4665184
2022-04-14,NYSE Arca (P),188488249,322485191,351777051,862750491,8928118847.675100,22348026536.757096,17020281000.312700,48296426384.744896,2039029,1498624,3054670,6592323
2022-04-14,NASDAQ (Q),453360530,222654875,1015463850,1691479255,23746856812.695994,18849788964.422999,64937174359.677230,107533820136.796223,6205664,1656102,8217880,16079646
2022-04-14,Members Exchange (U),142672639,80058719,151547914,374279272,4603544147.421400,4846151727.790001,4986655924.990602,14436351800.202003,1286002,437777,1162364,2886143
2022-04-14,Investors Exchange (V),136730253,28254641,102897073,267881967,8677216988.310800,2140563096.510700,7325396685.959100,18143176770.780600,1757321,195923,1387432,3340676
2022-04-14,NASDAQ PSX (X),23149909,34030311,24769067,81949287,825916585.811300,2372262613.333100,1538644442.945500,4736823642.089900,242364,175868,280368,698600
2022-04-14,BYX Equities (Y),51531590,38308311,46511103,136351004,1689697324.293000,3022637394.549200,2052735225.229901,6765069944.072101,600940,233592,520046,1354578
2022-04-14,BZX Equities (Z),211936722,140341100,192957636,545235458,9758003387.434800,10850836657.448304,12538803141.857396,33147643186.740500,2778406,978983,2424369,6181758
2022-04-13,NYSE American (A),13952172,27043268,11118649,52114089,647489566.464000,934478192.020400,680925968.353200,2262893726.837600,162282,121905,118782,402969
2022-04-13,NASDAQ BX (B),19423621,15231996,26008710,60664327,1016041464.499400,1381063505.158300,1623670955.492200,4020775925.149900,364499,117355,368068,849922
2022-04-13,NYSE National (C),35499509,32969494,26850571,95319574,1120031593.505800,1632257379.157300,1032206912.661200,3784495885.324300,415690,209569,311846,937105
2022-04-13,FINRA / Nasdaq TRF Chicago (DB),7800551,2911102,12622493,23334146,315680708.006900,119966277.826000,779690995.591400,1215337981.424300,38377,10552,61220,110149
2022-04-13,FINRA / NYSE TRF (DN),199462695,123591722,492693878,815748295,8116905818.336603,4258787343.665202,16082205569.687310,28457898731.689115,1177147,293705,1435309,2906161
2022-04-13,FINRA / Nasdaq TRF Carteret (DQ),1253588363,734546819,1898661816,3886796998,58923115539.162006,41876457731.217292,74103555969.006909,174903129239.386207,6324387,2040059,6391831,14756277
2022-04-13,MIAX Pearl (H),35546300,39270118,39315683,114132101,1103824475.897600,2252588903.432699,1948127502.412700,5304540881.742999,386239,209181,336983,932403
2022-04-13,EDGA Equities (J),54762415,38100636,55457882,148320933,2324839111.292600,2239244829.475000,2494987500.621200,7059071441.388800,799893,280518,665156,1745567
2022-04-13,EDGX Equities (K),209505684,101207588,297481915,608195187,8667075499.221002,5440292578.085101,12519989292.920302,26627357370.226405,1915357,543972,2014283,4473612
2022-04-13,LTSE (L),29620,396,3848,33864,800255.660000,8507.100000,477831.590000,1286594.350000,56,9,33,98
2022-04-13,NYSE Chicago (M),10621533,8288354,12675282,31585169,863004896.784100,808580193.512000,2465354151.483499,4136939241.779599,49283,4667,41881,95831
2022-04-13,NYSE (N),792083623,45180142,64558389,901822154,42185546653.484005,3416247551.662700,3114616901.877001,48716411107.023706,3754566,200686,545775,4501027
2022-04-13,NYSE Arca (P),179605639,314315257,408019748,901940644,8016333665.425502,21148425049.724681,17298679622.823707,46463438337.973890,1925965,1375503,3085079,6386547
2022-04-13,NASDAQ (Q),436212602,226414782,994614134,1657241518,22135115697.738108,18561844929.587397,57430908502.605300,98127869129.930805,5984539,1622002,8172416,15778957
2022-04-13,Members Exchange (U),146036857,86050309,163541465,395628631,4474467865.342900,4895726512.753798,5257245456.495498,14627439834.592196,1283869,444103,1201383,2929355
2022-04-13,Investors Exchange (V),140876213,29034762,117848212,287759187,8828177350.564001,1971570870.397000,7949123951.679101,18748872172.640102,1813807,197867,1480441,3492115
2022-04-13,NASDAQ PSX (X),22716564,35792099,29364101,87872764,784569479.392500,2390195675.180400,1461737065.383400,4636502219.956300,233720,167432,262685,663837
2022-04-13,BYX Equities (Y),55453825,41431630,48837475,145722930,1683742495.455100,2868475368.016700,1971396797.343900,6523614660.815700,609651,225138,517545,1352334
2022-04-13,BZX Equities (Z),214980340,142786095,210052031,567818466,9304123108.512701,10354725256.012500,12231762404.287406,31890610768.812607,2838959,976709,2492883,6308551
2022-04-12,NYSE American (A),14650389,30815164,11520880,56986433,642398421.276100,998984914.046300,716212767.127700,2357596102.450100,174850,131925,125855,432630
2022-04-12,NASDAQ BX (B),20446777,16524771,26820423,63791971,1052328152.975900,1581923559.417300,1880711941.195699,4514963653.588899,411151,133588,407948,952687
2022-04-12,NYSE National (C),34871556,33573960,24747321,93192837,1049941306.048800,1605599074.224200,957603957.666900,3613144337.939900,408709,198329,301221,908259
2022-04-12,FINRA / Nasdaq TRF Chicago (DB),7833033,3817714,14104308,25755055,355012503.616100,172451075.678200,914973758.647600,1442437337.941900,41040,15031,67284,123355
2022-04-12,FINRA / NYSE TRF (DN),219906713,139250027,498491074,857647814,8599365449.462798,5151407500.262805,17160051900.494105,30910824850.219708,1263322,332188,1527450,3122960
2022-04-12,FINRA / Nasdaq TRF Carteret (DQ),1315627122,854677099,1930711269,4101015490,61252304892.426874,47609322606.552706,79061031703.120365,187922659202.099945,6531249,2265282,6650115,15446646
2022-04-12,MIAX Pearl (H),38474942,47741063,37734276,123950281,1149091461.802700,2885232071.335499,2328653251.198201,6362976784.336400,425574,257601,395335,1078510
2022-04-12,EDGA Equities (J),58211039,42640284,54224553,155075876,2465560193.138300,2457085521.525199,2933870906.020199,7856516620.683698,861130,320409,716620,1898159
2022-04-12,EDGX Equities (K),233058835,113159420,317240786,663459041,9228453847.728400,6430825355.077499,13991699949.704603,29650979152.510502,2121030,638644,2252786,5012460
2022-04-12,LTSE (L),2532,1804,20750,25086,613218.370000,76391.360000,2394808.480000,3084418.210000,39,19,68,126
2022-04-12,NYSE Chicago (M),21315460,5987617,14997865,42300942,1346350759.543500,1165644595.999600,2086488441.051300,4598483796.594400,60370,3734,50286,114390
2022-04-12,NYSE (N),872943006,54971284,70817121,998731411,45408502246.383697,4122689086.664899,3575726643.052699,53106917976.101295,4236535,242346,609531,5088412
2022-04-12,NYSE Arca (P),199829219,377910468,419883985,997623672,8838875796.657999,25610093588.405994,20159473328.695901,54608442713.759894,2183932,1770222,3529225,7483379
2022-04-12,NASDAQ (Q),480811934,276723842,1003415745,1760951521,24154683781.487492,23559143112.209803,61806398246.364773,109520225140.062068,6760115,2123343,9202118,18085576
2022-04-12,Members Exchange (U),166646889,99883655,158582471,425113015,4885573589.154000,6300522928.297199,5624906100.663700,16811002618.114899,1403407,556764,1268115,3228286
2022-04-12,Investors Exchange (V),145537413,32261253,111784593,289583259,9042630242.421400,2734918476.305000,8114561177.865799,19892109896.592199,1911492,213191,1514839,3639522
2022-04-12,NASDAQ PSX (X),24526200,42466605,27041514,94034319,832355908.654700,2675758014.812300,1779685166.403400,5287799089.870400,251623,201317,298251,751191
2022-04-12,BYX Equities (Y),60239703,41707537,48383529,150330769,1761120472.486000,3117716982.947401,2101089447.822500,6979926903.255901,668080,235746,555097,1458923
2022-04-12,BZX Equities (Z),237163822,181554725,221200308,639918855,10214835325.405700,14085674484.730102,14870820949.580896,39171330759.716698,3137468,1263721,2840913,7242102
2022-04-11,NYSE American (A),14384442,26247985,11746120,52378547,645414134.685200,1008578600.163400,700314809.974400,2354307544.823000,180556,114933,135339,430828
2022-04-11,NASDAQ BX (B),20274036,17128496,25588302,62990834,1048482830.417000,1635482804.054700,1824942614.986700,4508908249.458400,399588,133170,411029,943787
2022-04-11,NYSE National (C),34967833,29729422,24702686,89399941,1046000155.997300,1453545481.371800,918093120.645200,3417638758.014300,404957,173646,300484,879087
2022-04-11,FINRA / Nasdaq TRF Chicago (DB),8515942,3173172,14069979,25759093,365539628.538300,145030627.929100,740707883.169300,1251278139.636700,44926,14177,68854,127957
2022-04-11,FINRA / NYSE TRF (DN),220769800,118963867,471353608,811087275,8781744288.267198,4809182379.914901,15192340554.995603,28783267223.177702,1345907,317718,1624810,3288435
2022-04-11,FINRA / Nasdaq TRF Carteret (DQ),1358350520,718079466,1857822428,3934252414,62893585767.447917,43571433114.832092,77974692524.114416,184439711406.394425,6740044,2241628,7116099,16097771
2022-04-11,MIAX Pearl (H),39716458,39036422,34350485,113103365,1183550261.589300,2431108593.852999,1934893602.461500,5549552457.903799,434628,213921,380402,1028951
2022-04-11,EDGA Equities (J),60305943,41559325,52613637,154478905,2578576574.922200,2494649913.715500,2790954363.933700,7864180852.571400,886912,306020,731866,1924798
2022-04-11,EDGX Equities (K),236040837,102744445,304944601,643729883,9373025102.074009,6103859207.426198,13006354259.514794,28483238569.015001,2181773,602956,2267430,5052159
2022-04-11,LTSE (L),46843,700,25806,73349,2455607.410000,15002.000000,5916073.580000,8386682.990000,59,9,163,231
2022-04-11,NYSE Chicago (M),16812412,6469470,11119981,34401863,922798153.572000,988034507.299700,2012519548.673302,3923352209.545002,44496,3579,37590,85665
2022-04-11,NYSE (N),926719707,48389051,67715666,1042824424,48967683380.962298,3958046921.894799,3206486226.712100,56132216529.569197,4216943,228418,568610,5013971
2022-04-11,NYSE Arca (P),208030903,362277681,393932249,964240833,8860182021.306601,25225725359.448495,18591844118.674805,52677751499.429901,2190188,1656689,3480621,7327498
2022-04-11,NASDAQ (Q),486471793,248109575,1084345064,1818926432,24246391976.968596,21322688971.884008,64874848191.093482,110443929139.946086,6654496,1892179,9352776,17899451
2022-04-11,Members Exchange (U),173784464,88210841,180104399,442099704,5084379345.315700,5574006376.842201,5660252527.279903,16318638249.437804,1484933,494949,1398272,3378154
2022-04-11,Investors Exchange (V),142476243,30710404,114997092,288183739,9071751925.675200,2515485819.703300,8330094645.860502,19917332391.239002,1846975,199694,1520787,3567456
2022-04-11,NASDAQ PSX (X),25902998,41900401,29646429,97449828,851835452.200000,2815324264.757902,1573337981.119500,5240497698.077402,268885,203387,324272,796544
2022-04-11,BYX Equities (Y),57559598,40901326,51652964,150113888,1772947602.578700,3061540284.953501,2102462345.921300,6936950233.453501,655854,238385,572740,1466979
2022-04-11,BZX Equities (Z),235162487,157698082,215949697,608810266,9715438283.641400,12275931187.648602,13048599416.673495,35039968887.963497,3078230,1131063,2763600,6972893
2022-04-08,NYSE American (A),14237312,25840263,11334790,51412365,687435921.809000,779807628.962800,619484335.978600,2086727886.750400,171083,109455,122323,402861
2022-04-08,NASDAQ BX (B),19495198,14306641,23335261,57137100,1064449089.516600,1363985707.169800,1674894828.724600,4103329625.411000,406862,119188,382724,908774
2022-04-08,NYSE National (C),38129160,29253127,24747627,92129914,1089890069.151000,1429830958.105600,892171271.081200,3411892298.337800,412230,178449,283251,873930
2022-04-08,FINRA / Nasdaq TRF Chicago (DB),8489202,2777633,12768800,24035635,382041794.025500,112913875.844200,706645971.481700,1201601641.351400,44151,11921,58104,114176
2022-04-08,FINRA / NYSE TRF (DN),214798727,127222592,452487888,794509207,8851083328.769602,4671442106.669202,16455158545.800005,29977683981.238809,1282180,292168,1470721,3045069
2022-04-08,FINRA / Nasdaq TRF Carteret (DQ),1355009516,672300789,1769060906,3796371211,66286746592.237321,42711166171.004590,76301751623.218330,185299664386.460241,6512818,2084912,6338068,14935798
2022-04-08,MIAX Pearl (H),35801412,36246486,31333790,103381688,1166354992.173300,2274001474.574899,2031498540.855100,5471855007.603299,400475,202192,340999,943666
2022-04-08,EDGA Equities (J),58912542,35836539,48989176,143738257,2570002479.124700,2132419714.211100,2530589738.085300,7233011931.421100,862601,274049,666100,1802750
2022-04-08,EDGX Equities (K),222854312,92060751,291520202,606435265,9555625032.941799,5148256479.605301,12312253451.536599,27016134964.083699,2079795,523717,2097282,4700794
2022-04-08,LTSE (L),8149,436,28843,37428,585569.140000,9922.160000,4141199.430000,4736690.730000,77,6,90,173
2022-04-08,NYSE Chicago (M),16621551,10808652,7512660,34942863,800342891.482800,1519323273.657600,1327126706.099100,3646792871.239500,43921,3509,37782,85212
2022-04-08,NYSE (N),846190100,41377151,62952152,950519403,46837537092.123509,3244844700.778500,2993903905.015400,53076285697.917409,4029530,199231,532263,4761024
2022-04-08,NYSE Arca (P),193597800,308236749,344331750,846166299,8723241399.439501,21090182028.416115,16489515482.583904,46302938910.439520,2090188,1464589,3100689,6655466
2022-04-08,NASDAQ (Q),453986643,227356690,945609144,1626952477,23398616097.470202,19976454593.220401,58012973453.150894,101388044143.841497,6192211,1779423,8416783,16388417
2022-04-08,Members Exchange (U),155380715,79657867,167173621,402212203,4667823733.014300,4947429424.004301,5205154447.375100,14820407604.393701,1355383,451789,1244447,3051619
2022-04-08,Investors Exchange (V),145476887,27118236,105428652,278023775,9148398705.495400,2213750402.453701,7431220363.947600,18793369471.896701,1871254,190880,1445747,3507881
2022-04-08,NASDAQ PSX (X),25665822,39620321,26222681,91508824,865070729.669500,2430444117.873401,1617459191.059700,4912974038.602601,252962,199702,282963,735627
2022-04-08,BYX Equities (Y),56749915,35693201,51027206,143470322,1846350499.024400,2802691074.154000,2080160399.367701,6729201972.546101,637341,207839,558872,1404052
2022-04-08,BZX Equities (Z),221798429,144598929,198216028,564613386,9604213415.848303,11143420444.916205,12839744812.454300,33587378673.218808,2893853,1044489,2522200,6460542
2022-04-07,NYSE American (A),15514909,28226675,12950728,56692312,672222072.713700,949001136.932300,702304904.283500,2323528113.929500,191518,120307,138237,450062
2022-04-07,NASDAQ BX (B),24237540,17477896,25350214,67065650,1234843601.608200,1620500481.317500,1860941954.976500,4716286037.902200,471193,141780,440015,1052988
2022-04-07,NYSE National (C),41292883,33017297,24627817,98937997,1180727726.910800,1656376632.414500,930575621.921600,3767679981.246900,458187,200953,305082,964222
2022-04-07,FINRA / Nasdaq TRF Chicago (DB),11056205,3393954,14180305,28630464,455042331.535600,171927594.768300,969851953.402700,1596821879.706600,53338,13188,69739,136265
2022-04-07,FINRA / NYSE TRF (DN),271097919,125153768,469425089,865676776,10395390302.531706,4831139422.394199,18737899857.601794,33964429582.527699,1489827,300916,1602764,3393507
2022-04-07,FINRA / Nasdaq TRF Carteret (DQ),1599185354,701119441,1865250699,4165555494,74138779075.705801,39944359539.585706,87630405287.690908,201713543902.982415,7383870,2244865,6890505,16519240
2022-04-07,MIAX Pearl (H),41970855,42420861,42751911,127143627,1324660770.390100,2457377954.049100,2327360504.331500,6109399228.770700,441342,239204,392916,1073462
2022-04-07,EDGA Equities (J),67175165,45034872,53892868,166102905,2851749484.166000,2684745481.434600,2984955402.683500,8521450368.284100,957699,334930,742267,2034896
2022-04-07,EDGX Equities (K),267592834,103250947,302724172,673567953,10785363503.727202,5970377297.136202,14504035499.772696,31259776300.636100,2419267,603857,2341972,5365096
2022-04-07,LTSE (L),24538,3267,53850,81655,1103167.530000,80495.430000,5797809.240000,6981472.200000,82,22,98,202
2022-04-07,NYSE Chicago (M),14961136,6884079,9303085,31148300,1223767808.348800,665973971.908100,1376595102.152400,3266336882.409300,49873,4638,45430,99941
2022-04-07,NYSE (N),1007716926,50997280,70609428,1129323634,53281214284.490000,3960350039.556600,3512640946.617600,60754205270.664200,4577943,249480,612883,5440306
2022-04-07,NYSE Arca (P),234604397,356315090,350182603,941102090,9958749929.779003,24542023179.656311,19003681386.602903,53504454496.038217,2441035,1671347,3408700,7521082
2022-04-07,NASDAQ (Q),528365383,263343812,1027070096,1818779291,26653307733.269800,23017813705.029602,65402906360.956624,115074027799.256026,7156502,2061402,9287528,18505432
2022-04-07,Members Exchange (U),180820676,96686201,172549861,450056738,5436707782.226000,5781235065.286499,6064557608.882498,17282500456.394997,1564589,535106,1347927,3447622
2022-04-07,Investors Exchange (V),166205648,29976908,118777580,314960136,10552769454.343200,2494259947.454000,8712057840.885602,21759087242.682802,2090704,211509,1563902,3866115
2022-04-07,NASDAQ PSX (X),28390821,44139422,28832068,101362311,936646245.298200,2576782530.438600,1733168066.807100,5246596842.543900,288182,210786,310656,809624
2022-04-07,BYX Equities (Y),64360384,40803625,51342462,156506471,1988120156.391000,3180122907.001499,2214442075.374500,7382685138.766999,708022,233514,590758,1532294
2022-04-07,BZX Equities (Z),256923963,167291521,216215471,640430955,10914926201.612700,12812443889.503106,14533009613.209602,38260379704.325408,3297350,1169681,2820621,7287652
2022-04-06,NYSE American (A),17049298,33547399,13676688,64273385,828733898.680900,1227830039.105900,940874340.201600,2997438277.988400,208380,143995,156537,508912
2022-04-06,NASDAQ BX (B),25561570,22250543,30384179,78196292,1256890669.072800,2101442221.084701,2319987819.449300,5678320709.606801,488214,180384,501696,1170294
2022-04-06,NYSE National (C),43204702,36978922,32381575,112565199,1270478896.651800,1840492802.146600,1263701204.698400,4374672903.496800,521266,232050,397658,1150974
2022-04-06,FINRA / Nasdaq TRF Chicago (DB),11956297,4306024,15688832,31951153,606683119.752400,186625902.102000,1074464986.681300,1867774008.535700,55944,16345,79109,151398
2022-04-06,FINRA / NYSE TRF (DN),278189678,148612251,483605853,910407782,11047038133.929903,5765108562.995200,20956793961.879101,37768940658.804204,1545528,363283,1789908,3698719
2022-04-06,FINRA / Nasdaq TRF Carteret (DQ),1621423707,797945617,1999101135,4418470459,74934833695.980399,48366993905.076703,98487216701.816949,221789044302.874051,7765163,2596769,7876240,18238172
2022-04-06,MIAX Pearl (H),46895000,47892923,42266248,137054171,1451097013.316300,3008171881.548700,2953311155.697001,7412580050.562001,473640,266144,451443,1191227
2022-04-06,EDGA Equities (J),66492928,54564155,59385314,180442397,2893456431.566200,3274319314.851500,3703986758.635999,9871762505.053699,948476,408111,828288,2184875
2022-04-06,EDGX Equities (K),275801477,123870488,320805147,720477112,11267984325.103099,7346776282.277000,16770820316.669002,35385580924.049101,2554434,772874,2617591,5944899
2022-04-06,LTSE (L),11143,13610,8547,33300,1042066.780000,344314.020000,6273282.370000,7659663.170000,48,104,138,290
2022-04-06,NYSE Chicago (M),10723933,10006595,10658677,31389205,901786668.778000,1893621079.736000,2052594931.827300,4848002680.341300,71022,4423,64337,139782
2022-04-06,NYSE (N),1051618753,61434427,78453915,1191507095,57159347153.285786,4901862102.553401,4248684232.044902,66309893487.884089,4943072,309751,691043,5943866
2022-04-06,NYSE Arca (P),242466273,435439465,403049924,1080955662,10465429872.697601,30832903136.007313,24641374356.909098,65939707365.614012,2647100,2152267,3997940,8797307
2022-04-06,NASDAQ (Q),551456416,318751610,1206014015,2076222041,27920775839.226196,27529820668.130603,80428603829.107593,135879200336.464392,7792627,2518509,11077808,21388944
2022-04-06,Members Exchange (U),195514121,112581654,188510719,496606494,5623865275.728100,7092023788.417399,7168885317.733600,19884774381.879099,1619451,629281,1499915,3748647
2022-04-06,Investors Exchange (V),168177655,35296672,131321227,334795554,10445555018.606499,2908219514.271201,10468824000.547301,23822598533.425001,2187747,242998,1779839,4210584
2022-04-06,NASDAQ PSX (X),30749140,51138132,34510375,116397647,1035850069.071700,3157958626.069702,2349400208.810700,6543208903.952102,303177,276252,383329,962758
2022-04-06,BYX Equities (Y),70908651,49519746,53452497,173880894,2024433185.142800,3727198832.544799,2610338300.841998,8361970318.529597,714217,287519,623881,1625617
2022-04-06,BZX Equities (Z),278638535,203967720,257152504,739758759,12118704808.108401,16016687189.841901,18795521797.230604,46930913795.180906,3612667,1480566,3356820,8450053
2022-04-05,NYSE American (A),14994319,30125945,11253452,56373716,681661074.163900,985601465.570800,707514071.858700,2374776611.593400,173681,131035,129095,433811
2022-04-05,NASDAQ BX (B),23120845,18494151,23924311,65539307,1084876857.849900,1727983544.531601,1802636508.900901,4615496911.282402,408277,157024,393015,958316
2022-04-05,NYSE National (C),42375139,33127224,28619144,104121507,1161911388.375900,1581485124.578000,1006117729.126100,3749514242.080000,455665,192681,330498,978844
2022-04-05,FINRA / Nasdaq TRF Chicago (DB),11713298,3607427,12922447,28243172,488895877.698100,152213025.736500,890858057.474599,1531966960.909199,58666,13798,65655,138119
2022-04-05,FINRA / NYSE TRF (DN),277991619,131249887,441347898,850589404,10766098804.552596,4643498252.742699,17249756854.175384,32659353911.470679,1574872,333791,1642119,3550782
2022-04-05,FINRA / Nasdaq TRF Carteret (DQ),1621252344,781896830,1831041041,4234190215,72198110518.431681,45427704768.263900,86923221753.448763,204549037040.144344,7519042,2300868,7145116,16965026
2022-04-05,MIAX Pearl (H),43390712,35118848,34955575,113465135,1334107461.883700,2355859294.468499,2315626907.329300,6005593663.681499,438688,210556,378738,1027982
2022-04-05,EDGA Equities (J),63774193,43385933,52666131,159826257,2628399840.845800,2671080557.332000,3175892322.369799,8475372720.547599,863118,321487,712307,1896912
2022-04-05,EDGX Equities (K),288042274,111521545,293124460,692688279,11578552490.966198,5962160434.938602,14761402683.420308,32302115609.325108,2494054,609155,2326840,5430049
2022-04-05,LTSE (L),502,16068,15790,32360,240389.470000,506915.250000,129192.930000,876497.650000,15,168,182,365
2022-04-05,NYSE Chicago (M),14584901,9223117,8345955,32153973,876907688.032700,971281576.665600,1280690423.840500,3128879688.538800,69765,4569,57160,131494
2022-04-05,NYSE (N),980291835,50663243,65601170,1096556248,52588048802.235407,4170761237.574400,3339315818.740399,60098125858.550206,4431956,246928,578834,5257718
2022-04-05,NYSE Arca (P),229020126,380532378,331343905,940896409,9800451542.158499,26035573917.638902,19545133360.744900,55381158820.542301,2385572,1745974,3330028,7461574
2022-04-05,NASDAQ (Q),509877808,255348937,1023876395,1789103140,25762665697.614700,20329885850.659397,68074810512.697605,114167362060.971702,6865600,1869561,9134214,17869375
2022-04-05,Members Exchange (U),183169227,96968910,163754438,443892575,5459002645.237900,5772040617.748896,6273812463.102100,17504855726.088896,1531305,510960,1334038,3376303
2022-04-05,Investors Exchange (V),148705665,36085964,115186145,299977774,9188382636.519098,2747847074.352300,8591260237.470399,20527489948.341797,1951086,225108,1565154,3741348
2022-04-05,NASDAQ PSX (X),30170412,41541975,28406264,100118651,1060493852.800200,2585298212.880500,1923895689.038900,5569687754.719600,293216,207330,308093,808639
2022-04-05,BYX Equities (Y),65997826,46391079,48957708,161346613,1827273416.813100,3508375828.152900,2380685385.793901,7716334630.759901,662641,280369,567413,1510423
2022-04-05,BZX Equities (Z),252147459,161332651,212373966,625854076,10701735865.768001,11798445183.357296,14231384289.256595,36731565338.381892,3232344,1098368,2755077,7085789
2022-04-04,NYSE American (A),12379341,32489750,10725497,55594588,551108759.750800,822108087.422200,629114843.295800,2002331690.468800,160724,131919,121639,414282
2022-04-04,NASDAQ BX (B),20979951,15217629,21515655,57713235,995715230.132900,1220711646.871700,1506596939.999200,3723023817.003800,388112,123474,355245,866831
2022-04-04,NYSE National (C),39407784,30491879,26147129,96046792,1081557634.294000,1390286363.379300,872497954.585800,3344341952.259100,448856,173195,306501,928552
2022-04-04,FINRA / Nasdaq TRF Chicago (DB),12036662,3459762,13460904,28957328,540734613.175500,119701753.841400,856901183.587600,1517337550.604500,54571,13547,66577,134695
2022-04-04,FINRA / NYSE TRF (DN),281332648,154859274,464883346,901075268,11137396114.619302,4424259645.457699,17616141723.377107,33177797483.454108,1611301,360054,1685848,3657203
2022-04-04,FINRA / Nasdaq TRF Carteret (DQ),1563210283,827585864,1829681062,4220477209,70810386956.349280,43228894309.185990,83841159131.286771,197880440396.822041,7218953,2378174,6863836,16460963
2022-04-04,MIAX Pearl (H),39750500,28938066,30581224,99269790,1170771898.247900,1768306977.490600,1942898051.728600,4881976927.467100,406932,167692,332897,907521
2022-04-04,EDGA Equities (J),60948290,38556594,48128771,147633655,2566352314.103400,2092003489.389200,2481919563.460899,7140275366.953499,862621,285878,682762,1831261
2022-04-04,EDGX Equities (K),255785092,105244900,268324648,629354640,10569500198.485901,4713429597.853502,13907318018.629400,29190247814.968803,2248173,531927,2069597,4849697
2022-04-04,LTSE (L),144,6367,24730,31241,65849.340000,233868.370000,961006.268600,1260723.978600,5,88,100,193
2022-04-04,NYSE Chicago (M),9800688,5050198,10665861,25516747,737963347.185300,591671575.398100,2442627697.163400,3772262619.746800,40171,2804,38670,81645
2022-04-04,NYSE (N),916905972,41904223,62307610,1021117805,49817432655.519794,3093547967.927200,3160089303.032200,56071069926.479194,4250207,198293,564409,5012909
2022-04-04,NYSE Arca (P),215332045,338549967,322928481,876810493,9392118330.496401,21405378568.024091,17682716786.703501,48480213685.223993,2309272,1427742,3160728,6897742
2022-04-04,NASDAQ (Q),496923160,229034761,986611258,1712569179,24860983095.525695,17272811135.558600,64623762987.078304,106757557218.162599,6608163,1598299,8764736,16971198
2022-04-04,Members Exchange (U),165845586,94734884,157020056,417600526,4881828867.988901,4563426858.558698,5372243475.999000,14817499202.546599,1467127,453761,1283492,3204380
2022-04-04,Investors Exchange (V),142488228,30033754,113308950,285830932,8799812011.993401,2076352517.954200,8263396895.202503,19139561425.150104,1835280,203282,1523549,3562111
2022-04-04,NASDAQ PSX (X),23822654,35657185,24325333,83805172,725149712.713700,2012264997.847000,1294143262.091000,4031557972.651700,237567,169211,257033,663811
2022-04-04,BYX Equities (Y),60418048,48222528,44437419,153077995,1729520540.754900,2954834775.234500,1903971152.569600,6588326468.559000,632297,241694,522044,1396035
2022-04-04,BZX Equities (Z),229983348,136861235,195032015,561876598,9669807206.459996,9622351390.076204,12184662031.415597,31476820627.951797,3055756,910260,2548252,6514268
2022-04-01,NYSE American (A),16371266,28764881,12871648,58007795,746879859.546900,808050954.664300,758988598.038500,2313919412.249700,193545,124147,143962,461654
2022-04-01,NASDAQ BX (B),21309712,16606306,22462809,60378827,1051380751.316200,1469485740.510000,1549139465.725500,4070005957.551700,398041,129869,374054,901964
2022-04-01,NYSE National (C),40029169,30891047,28049491,98969707,1127415491.130000,1445758488.437300,983774920.759500,3556948900.326800,435342,184363,317310,937015
2022-04-01,FINRA / Nasdaq TRF Chicago (DB),10618107,3844753,14522375,28985235,397910425.578200,173775414.339500,859607775.922400,1431293615.840100,51055,16363,70848,138266
2022-04-01,FINRA / NYSE TRF (DN),260970794,144274411,500473436,905718641,9466498938.796505,5177795811.184799,18002449607.025408,32646744357.006712,1429051,359483,1638273,3426807
2022-04-01,FINRA / Nasdaq TRF Carteret (DQ),1447533569,762166839,1943069052,4152769460,66153511388.645008,47254881919.172311,84446223416.743665,197854616724.560984,6982620,2272920,7063642,16319182
2022-04-01,MIAX Pearl (H),43206807,31427174,33081760,107715741,1180029716.718600,1973064273.093100,1950576709.464200,5103670699.275900,406721,181285,354085,942091
2022-04-01,EDGA Equities (J),61292605,40307518,49017270,150617393,2551826015.455200,2190357048.504500,2643969963.739600,7386153027.699300,836644,305545,692388,1834577
2022-04-01,EDGX Equities (K),250138968,109067994,287161814,646368776,9720371065.617300,5738993967.866903,13684824864.377090,29144189897.861293,2203190,589084,2222510,5014784
2022-04-01,LTSE (L),2586,5452,11864,19902,538460.160000,151633.510000,334659.500000,1024753.170000,14,32,86,132
2022-04-01,NYSE Chicago (M),11013984,12193781,8862993,32070758,743782324.201400,1798661518.860000,1446638907.191800,3989082750.253200,56872,3272,52074,112218
2022-04-01,NYSE (N),995807410,46520859,70408462,1112736731,54640717219.997893,3778219000.701899,3511181310.667201,61930117531.366993,4399200,228446,632416,5260062
2022-04-01,NYSE Arca (P),225456145,361310305,344585686,931352136,9726290599.091399,24193033111.958892,18839470387.837398,52758794098.887689,2462824,1604945,3491721,7559490
2022-04-01,NASDAQ (Q),509331402,251114337,1104692326,1865138065,25067873463.835393,20556125528.177199,68112978325.192544,113736977317.205136,6782833,1835540,9385861,18004234
2022-04-01,Members Exchange (U),173319108,91653385,166731547,431704040,4998577341.083200,5595720288.523398,5564288981.003298,16158586610.609896,1477096,511891,1355657,3344644
2022-04-01,Investors Exchange (V),154853979,30583503,122158547,307596029,9536054523.225702,2205962607.064999,8697189594.264400,20439206724.555101,1950749,214150,1641196,3806095
2022-04-01,NASDAQ PSX (X),27649649,37005759,28206069,92861477,854415181.545300,2262281579.172800,1596435631.114800,4713132391.832900,264390,175554,298062,738006
2022-04-01,BYX Equities (Y),63895194,40783729,47376467,152055390,1825929436.683200,2848818780.517298,2070660537.589000,6745408754.789498,648965,230175,552175,1431315
2022-04-01,BZX Equities (Z),250149306,159460198,219055988,628665492,10659581858.912200,12149909622.023297,14456166973.304701,37265658454.240198,3311970,1111397,2832840,7256207
2022-03-31,NYSE American (A),17797599,36501931,13566208,67865738,836352440.011600,1032221855.836100,713126611.457600,2581700907.305300,201774,120685,136645,459104
2022-03-31,NASDAQ BX (B),24691792,19503075,22776552,66971419,1123506540.169600,1893492303.032500,1647323317.206300,4664322160.408400,386622,139409,342185,868216
2022-03-31,NYSE National (C),45741804,34412619,30198138,110352561,1331729781.604900,1747152011.091000,1091749869.569600,4170631662.265500,503685,194000,341336,1039021
2022-03-31,FINRA / Nasdaq TRF Chicago (DB),8766899,2899569,15072760,26739228,352990978.930300,152619407.923800,808859511.631300,1314469898.485400,45419,12896,71279,129594
2022-03-31,FINRA / NYSE TRF (DN),247291981,122305830,545351830,914949641,9170506429.956402,4739260527.419999,18355041895.055793,32264808852.432194,1394625,302324,1659319,3356268
2022-03-31,FINRA / Nasdaq TRF Carteret (DQ),1506885589,748114286,2116109535,4371109410,71236055162.956632,54968001257.402106,91320261126.830211,217524317547.188949,7081856,2044346,6995349,16121551
2022-03-31,MIAX Pearl (H),41537261,36031615,39250311,116819187,1367313136.559000,2501735449.668700,2272622080.230100,6141670666.457800,435507,207152,368577,1011236
2022-03-31,EDGA Equities (J),64185920,38571343,54290306,157047569,2749278813.665400,2529549587.501200,2922101675.264200,8200930076.430800,883762,281465,696967,1862194
2022-03-31,EDGX Equities (K),247191775,105280687,325202958,677675420,9991953899.717500,6858039078.086200,14444868478.125099,31294861455.928799,2232772,601098,2238793,5072663
2022-03-31,LTSE (L),1287,36882,50510,88679,1310200.180000,3823688.900000,649747.940000,5783637.020000,29,77,107,213
2022-03-31,NYSE Chicago (M),10065362,12161415,13693351,35920128,810003473.190200,2261094334.188000,1976409456.216400,5047507263.594600,56299,3557,53978,113834
2022-03-31,NYSE (N),1185148175,48255484,70835859,1304239518,69811076460.739899,4149503029.582700,3533748527.014000,77494328017.336599,4364870,239392,557540,5161802
2022-03-31,NYSE Arca (P),235098960,383242602,388555805,1006897367,10175436566.983999,28698435526.886492,20249658335.634297,59123530429.504788,2371158,1634750,3376016,7381924
2022-03-31,NASDAQ (Q),505032455,256140049,1193546269,1954718773,25728665086.495711,23565100012.978615,82623181884.048842,131916946983.523168,6559896,1857777,8960234,17377907
2022-03-31,Members Exchange (U),177615075,96291529,192103893,466010497,5301796741.349800,6444435891.138300,6199577621.282501,17945810253.770601,1463767,510744,1334266,3308777
2022-03-31,Investors Exchange (V),158147941,34564685,123403575,316116201,10149340135.272500,2618730807.148400,9166293627.918699,21934364570.339599,2021121,220978,1617935,3860034
2022-03-31,NASDAQ PSX (X),31491225,39529970,32584209,103605404,1115110253.936900,2819420325.036399,1764167336.407100,5698697915.380399,309343,203745,329869,842957
2022-03-31,BYX Equities (Y),70206318,49532294,57654553,177393165,2017164888.023600,3525726483.157099,2399184195.769800,7942075566.950499,694962,263235,586658,1544855
2022-03-31,BZX Equities (Z),246122730,159372556,219645867,625141153,11019416827.690600,13044587019.366803,14710129701.612803,38774133548.670206,3198104,1081175,2692542,6971821
2022-03-30,NYSE American (A),15758530,27061663,14622038,57442231,720324272.198900,822004564.707200,688547292.341600,2230876129.247700,181646,114324,138999,434969
2022-03-30,NASDAQ BX (B),18717934,15609411,20363199,54690544,973253623.000000,1459424205.179200,1476081140.272600,3908758968.451800,350153,121459,327578,799190
2022-03-30,NYSE National (C),37771571,27882183,26136029,91789783,1104318315.600900,1383829839.326500,812042989.099700,3300191144.027100,414516,173249,288054,875819
2022-03-30,FINRA / Nasdaq TRF Chicago (DB),9428054,3274717,22163475,34866246,405857617.193800,173718924.903300,932591796.725800,1512168338.822900,49615,13206,78478,141299
2022-03-30,FINRA / NYSE TRF (DN),249802767,128497208,607408935,985708910,9567790067.141899,4848999989.721399,19525721331.113000,33942511387.976298,1370318,309451,1739254,3419023
2022-03-30,FINRA / Nasdaq TRF Carteret (DQ),1400343232,758408620,2110879887,4269631739,63305794600.300184,46056203027.997724,88571328472.486992,197933326100.784900,6896997,2060962,7234785,16192744
2022-03-30,MIAX Pearl (H),40473246,33125343,39988742,113587331,1271548382.954200,2336106519.272900,2320613327.024000,5928268229.251100,426938,195054,397448,1019440
2022-03-30,EDGA Equities (J),58914978,35956792,50139144,145010914,2502550905.141100,2253704434.087900,2548488047.667901,7304743386.896901,863639,264882,679162,1807683
2022-03-30,EDGX Equities (K),255799925,101382707,350045025,707227657,10273611471.377801,5685898573.829996,15538514487.466401,31498024532.674198,2238327,554681,2350578,5143586
2022-03-30,LTSE (L),45079,7483,28473,81035,5679885.390000,189358.470000,2362110.500000,8231354.360000,19,78,201,298
2022-03-30,NYSE Chicago (M),15891888,7874240,17550426,41316554,1127761012.705500,1640851190.558200,3809720232.753002,6578332436.016702,61640,3988,61544,127172
2022-03-30,NYSE (N),931157812,45253489,73151499,1049562800,49110816265.038505,3701811097.580100,3507677279.585800,56320304642.204405,4074848,219508,588761,4883117
2022-03-30,NYSE Arca (P),218493444,352866047,420296543,991656034,9268497146.281401,24552171426.668610,19196578292.240098,53017246865.190109,2284176,1582642,3467703,7334521
2022-03-30,NASDAQ (Q),488775646,239322884,1094616265,1822714795,24568479927.515902,20174943979.183311,65981733010.099503,110725156916.798716,6472193,1745863,8869909,17087965
2022-03-30,Members Exchange (U),175128158,88728374,199230533,463087065,5008117738.384700,5462438561.827801,6147706167.525000,16618262467.737501,1455445,477352,1396399,3329196
2022-03-30,Investors Exchange (V),142216221,28969351,119472784,290658356,9021190237.361000,2095395478.046600,8691708677.649904,19808294393.057504,1835538,195128,1535620,3566286
2022-03-30,NASDAQ PSX (X),28434740,36135578,32876820,97447138,901858983.829800,2435967510.850800,1568933396.307000,4906759890.987600,267097,191828,310010,768935
2022-03-30,BYX Equities (Y),60721074,40571353,56461995,157754422,1802526334.758200,2997082846.363400,2170995524.103400,6970604705.225000,657190,236803,594503,1488496
2022-03-30,BZX Equities (Z),237700309,145861619,223777109,607339037,10261585862.099499,11187670194.165801,13142664131.403003,34591920187.668303,3081092,1006902,2704813,6792807
2022-03-29,NYSE American (A),18892357,33146196,14671801,66710354,833650432.124800,1104346917.240301,824254376.351200,2762251725.716301,217278,138132,154257,509667
2022-03-29,NASDAQ BX (B),23120201,16788341,25092460,65001002,1153404409.690000,1466298872.686000,1831721504.631000,4451424787.007000,441120,134224,405163,980507
2022-03-29,NYSE National (C),43830560,29879693,30740163,104450416,1243057792.403700,1473984841.642900,1004652804.248800,3721695438.295400,491415,185118,332640,1009173
2022-03-29,FINRA / Nasdaq TRF Chicago (DB),10985041,3264060,18000753,32249854,553184841.158300,163305758.083800,984614517.253700,1701105116.495800,57914,15293,81713,154920
2022-03-29,FINRA / NYSE TRF (DN),283333309,139181343,647840534,1070355186,11378768573.906395,5591849461.955097,21804946032.758603,38775564068.620095,1632841,352078,1918846,3903765
2022-03-29,FINRA / Nasdaq TRF Carteret (DQ),1652318571,831414139,2380249345,4863982055,76431911088.761482,50706102153.660113,99111989173.475918,226250002415.897513,7932563,2474008,7976616,18383187
2022-03-29,MIAX Pearl (H),43170761,37164518,41789915,122125194,1351419493.186400,2334668699.620100,2315813457.612200,6001901650.418700,462460,210088,414820,1087368
2022-03-29,EDGA Equities (J),68434724,41790838,59447525,169673087,2905401445.609800,2478866688.724300,2982949507.303400,8367217641.637500,966201,295872,759236,2021309
2022-03-29,EDGX Equities (K),304165357,120352756,385129924,809648037,12281571457.446304,6903184669.243800,17916678800.507410,37101434927.197514,2642956,671674,2585294,5899924
2022-03-29,LTSE (L),234549,0,218402,452951,11917870.100000,0.000000,11862042.720000,23779912.820000,41,0,181,222
2022-03-29,NYSE Chicago (M),17996206,8535445,10010070,36541721,1678958878.077400,2031688693.951700,1768000738.489000,5478648310.518100,65160,3908,52524,121592
2022-03-29,NYSE (N),995405374,50593747,80583484,1126582605,52939043197.973590,4179048360.327799,3852463233.078299,60970554791.379688,4495034,246302,654037,5395373
2022-03-29,NYSE Arca (P),270620925,422520102,488855725,1181996752,12144323680.673605,29297987988.682071,23732033950.056398,65174345619.412074,2810706,1883051,3986182,8679939
2022-03-29,NASDAQ (Q),582340746,277635618,1187866121,2047842485,29083744090.057898,23291373001.536395,75535310814.502433,127910427906.096726,7486967,2047107,9883031,19417105
2022-03-29,Members Exchange (U),215386302,103853152,205076593,524316047,6183541884.454200,6048658135.408103,6661273251.817600,18893473271.679903,1727853,568913,1477390,3774156
2022-03-29,Investors Exchange (V),169114927,33246867,137946720,340308514,10890867460.198202,2717158815.839400,10313994318.323401,23922020594.361003,2180380,223617,1817310,4221307
2022-03-29,NASDAQ PSX (X),29818739,38788725,31235890,99843354,955425267.142400,2737662309.487900,1828970500.429200,5522058077.059500,294669,215814,333875,844358
2022-03-29,BYX Equities (Y),70718874,44098738,62314602,177132214,2085006758.896600,3108554515.979901,2459170123.317200,7652731398.193701,744974,247482,628085,1620541
2022-03-29,BZX Equities (Z),286024877,172084906,253821888,711931671,12159417290.251098,12803228327.657105,14921393958.276094,39884039576.184297,3621589,1178452,3024164,7824205
2022-03-28,NYSE American (A),15775585,33665579,13905931,63347095,682601458.695100,791353526.560500,627998951.882000,2101953937.137600,176604,126385,128917,431906
2022-03-28,NASDAQ BX (B),19174158,16157732,20987924,56319814,901498237.617800,1352151128.984300,1604198421.570100,3857847788.172200,354599,124541,354289,833429
2022-03-28,NYSE National (C),36203871,27183628,27630188,91017687,1004208115.524200,1346801816.207100,852864653.657900,3203874585.389200,402778,189862,297580,890220
2022-03-28,FINRA / Nasdaq TRF Chicago (DB),8921421,3173526,14786009,26880956,417664564.744200,134627433.861200,1080815849.116500,1633107847.721900,47295,13401,73524,134220
2022-03-28,FINRA / NYSE TRF (DN),264760361,138184319,574868572,977813252,10070358809.389705,4671208196.080197,20482918808.639193,35224485814.109095,1537648,329251,1766699,3633598
2022-03-28,FINRA / Nasdaq TRF Carteret (DQ),1428804355,720263410,2060900029,4209967794,64733813482.463492,39541846556.491615,88611464996.020428,192887125034.975535,6850578,2246413,7040999,16137990
2022-03-28,MIAX Pearl (H),40471471,31847837,35469522,107788830,1159100011.700900,1933976538.852500,2176137156.416200,5269213706.969600,404339,192025,350899,947263
2022-03-28,EDGA Equities (J),55667934,32650465,48517649,136836048,2307459166.878100,1837837649.539000,2354911287.980999,6500208104.398099,796515,251540,642514,1690569
2022-03-28,EDGX Equities (K),255863361,112342772,322902461,691108594,9709753609.609798,5299604101.306403,15657620083.167707,30666977794.083908,2159378,595471,2212253,4967102
2022-03-28,LTSE (L),1463,4,280461,281928,94064.900000,116.000000,470087.571400,564268.471400,10,2,386,398
2022-03-28,NYSE Chicago (M),8908051,6273287,10816009,25997347,678966326.356400,989016516.713700,1763591101.701400,3431573944.771500,71399,5130,67219,143748
2022-03-28,NYSE (N),856857666,45495108,68485692,970838466,44372897041.737694,3482959285.046102,3134156483.033401,50990012809.817197,3820238,224916,544758,4589912
2022-03-28,NYSE Arca (P),214104268,339361748,376155033,929621049,8776086087.112493,22088874733.512610,20146233960.986595,51011194781.611698,2195404,1571007,3274573,7040984
2022-03-28,NASDAQ (Q),474588082,233911312,973798196,1682297590,22337057261.115002,18530523676.194100,64998829552.345876,105866410489.654978,6028693,1732201,8368609,16129503
2022-03-28,Members Exchange (U),174933362,92075586,175754759,442763707,4955944154.118500,4974157281.611001,5517912443.366703,15448013879.096204,1436573,481816,1272319,3190708
2022-03-28,Investors Exchange (V),138889491,26938256,109461302,275289049,8152334816.705900,1854224405.713600,7887524057.400700,17894083279.820200,1715429,182616,1428515,3326560
2022-03-28,NASDAQ PSX (X),24652960,34135233,26926611,85714804,728200242.466000,2051563807.176500,1454968107.645800,4234732157.288300,231369,185630,284515,701514
2022-03-28,BYX Equities (Y),61316839,39891305,53524546,154732690,1709676265.703200,2641726817.458701,2015015702.936600,6366418786.098501,640929,230161,554541,1425631
2022-03-28,BZX Equities (Z),232370224,145247533,214338724,591956481,9258481094.599302,10280616644.316297,13544066902.949396,33083164641.864995,2923001,1046040,2597937,6566978
2022-03-25,NYSE American (A),16870842,32519024,12516314,61906180,684908251.649300,825788992.015800,593592181.049900,2104289424.715000,178762,127939,130148,436849
2022-03-25,NASDAQ BX (B),19072386,14980452,20641332,54694170,904801226.224200,1305166338.721700,1371336543.560900,3581304108.506800,355528,127459,342899,825886
2022-03-25,NYSE National (C),38019161,27484863,26904707,92408731,978198734.651400,1242954331.518500,865785168.740100,3086938234.910000,412165,159352,290701,862218
2022-03-25,FINRA / Nasdaq TRF Chicago (DB),9291366,4543792,23703651,37538809,406887132.920700,153723558.073900,980760949.659900,1541371640.654500,46510,14075,69961,130546
2022-03-25,FINRA / NYSE TRF (DN),242878147,171985243,656799939,1071663329,8935684682.069599,4830284996.316701,20016736148.718108,33782705827.104408,1339221,338393,1680156,3357770
2022-03-25,FINRA / Nasdaq TRF Carteret (DQ),1373745360,808429847,2277152443,4459327650,59174989384.430391,42168379076.392408,86364091401.600511,187707459862.423310,6526114,2116307,6926138,15568559
2022-03-25,MIAX Pearl (H),39868628,36787710,38959023,115615361,1113456761.325700,2112157859.483300,2019108145.618100,5244722766.427100,395062,203694,375275,974031
2022-03-25,EDGA Equities (J),58802891,33501568,52571773,144876232,2154650545.439400,1860632021.150900,2555853351.980700,6571135918.571000,781776,244248,665064,1691088
2022-03-25,EDGX Equities (K),254543736,120046049,340768725,715358510,9165692304.860097,5546142045.404502,14456394911.932994,29168229262.197593,2109379,586525,2227466,4923370
2022-03-25,LTSE (L),32348,28,247252,279628,1101533.960000,942.200000,823323.957900,1925800.117900,36,3,253,292
2022-03-25,NYSE Chicago (M),13701925,10554329,7512492,31768746,768503723.075400,2921785366.705200,1167850868.821400,4858139958.602000,61199,4321,56281,121801
2022-03-25,NYSE (N),872767731,44353836,76854483,993976050,43981116743.136691,3504776348.832400,3092967731.397100,50578860823.366191,3899154,210665,557787,4667606
2022-03-25,NYSE Arca (P),217026102,323265399,414768964,955060465,8494355184.972102,20299915110.419806,17425873721.763992,46220144017.155900,2202608,1481694,3209193,6893495
2022-03-25,NASDAQ (Q),482842539,235326105,1030674752,1748843396,22201410301.953102,18415071782.023791,59321414426.881591,99937896510.858484,6013172,1650244,8373409,16036825
2022-03-25,Members Exchange (U),182967543,90070181,184199413,457237137,4862430279.343700,4985561873.313801,5682003566.671798,15529995719.329299,1413766,475149,1278376,3167291
2022-03-25,Investors Exchange (V),142835108,28806536,109823066,281464710,8184577145.813797,2051101735.182500,7558515068.324400,17794193949.320697,1764353,190705,1428913,3383971
2022-03-25,NASDAQ PSX (X),27537645,35332419,30521984,93392048,785142919.767100,2137024971.588100,1435701281.946700,4357869173.301900,246984,182175,306627,735786
2022-03-25,BYX Equities (Y),63561646,40324386,53563146,157449178,1573948496.214800,2881485164.944599,2071266843.133600,6526700504.292999,623913,227897,568469,1420279
2022-03-25,BZX Equities (Z),248658614,144894848,226917550,620471012,9658050361.186102,10371116189.120201,13803898317.778902,33833064868.085205,2995386,984447,2682321,6662154
2022-03-24,NYSE American (A),14436254,29753220,14236065,58425539,610752794.015900,725873384.122600,700271093.470200,2036897271.608700,167939,120629,133259,421827
2022-03-24,NASDAQ BX (B),18207615,14941994,20047260,53196869,911007672.683800,1149686721.227500,1488277511.765300,3548971905.676600,367672,109652,363768,841092
2022-03-24,NYSE National (C),37876607,30440620,24876216,93193443,978357272.951200,1315030355.075500,797928880.201400,3091316508.228100,413204,173651,280102,866957
2022-03-24,FINRA / Nasdaq TRF Chicago (DB),8613079,3459114,14283933,26356126,400187480.801600,117050251.041400,967540649.430700,1484778381.273700,45172,11924,71482,128578
2022-03-24,FINRA / NYSE TRF (DN),242421402,158236992,561724756,962383150,9259954178.272396,4701772068.803099,21586349653.221207,35548075900.296702,1272175,318469,1635485,3226129
2022-03-24,FINRA / Nasdaq TRF Carteret (DQ),1338827194,741807126,2044096321,4124730641,60947363997.242222,35945440209.761407,91110604173.205159,188003408380.208788,6393369,1939880,6869481,15202730
2022-03-24,MIAX Pearl (H),35960023,33319546,37260320,106539889,1070423151.843000,1871484949.217299,1991022104.557600,4932930205.617899,364795,194071,355704,914570
2022-03-24,EDGA Equities (J),58131340,33977458,50362182,142470980,2306466038.167500,1738823885.329700,2603137671.622699,6648427595.119899,794167,236957,667361,1698485
2022-03-24,EDGX Equities (K),242060838,118603468,313368818,674033124,9449991222.395604,5044397756.280201,15453558009.237999,29947946987.913804,2061586,582236,2263027,4906849
2022-03-24,LTSE (L),25370,0,23160,48530,1388105.970000,0.000000,338107.480000,1726213.450000,16,0,140,156
2022-03-24,NYSE Chicago (M),19776826,7019402,14611428,41407656,1449531404.656700,860653651.945900,2466026321.402100,4776211378.004700,62267,3803,64583,130653
2022-03-24,NYSE (N),836325065,42710197,69783257,948818519,43823020435.254799,2876505263.383300,3298112373.046001,49997638071.684100,3807544,192889,553428,4553861
2022-03-24,NYSE Arca (P),204528923,309951040,402743500,917223463,8670484073.114796,19075659844.227097,18145672231.034616,45891816148.376509,2187698,1390772,3003538,6582008
2022-03-24,NASDAQ (Q),460506839,230546144,1002549791,1693602774,21989979645.120602,16546620625.090801,65331360439.962873,103867960710.174276,5972701,1539521,8818335,16330557
2022-03-24,Members Exchange (U),164960755,89738841,167893563,422593159,4655963768.451300,4558865033.191000,5820782215.052197,15035611016.694497,1362432,456578,1265520,3084530
2022-03-24,Investors Exchange (V),137157843,29513644,115149710,281821197,8222759940.377800,2019446422.304700,8628137298.978099,18870343661.660599,1728147,184839,1502286,3415272
2022-03-24,NASDAQ PSX (X),25356760,33074789,29481502,87913051,728280023.819000,2047564408.652300,1507623385.495800,4283467817.967100,238064,167528,308545,714137
2022-03-24,BYX Equities (Y),60556343,38225369,50883166,149664878,1636349686.767900,2379200062.884500,2079527744.591600,6095077494.244000,643392,207645,565708,1416745
2022-03-24,BZX Equities (Z),225661207,143172228,216147212,584980647,9337238978.882196,9759511566.499996,13758260096.302400,32855010641.684592,2866254,947067,2669010,6482331
2022-03-23,NYSE American (A),17332418,31383239,14370337,63085994,801325047.997300,794011748.701100,753710797.468200,2349047594.166600,198038,122121,158868,479027
2022-03-23,NASDAQ BX (B),21065919,16087525,21655034,58808478,1067780131.556800,1337161940.037400,1793256096.965100,4198198168.559300,399620,126101,399214,924935
2022-03-23,NYSE National (C),40779149,33958366,28460933,103198448,1125595800.798900,1511152970.414500,963917593.372600,3600666364.586000,455213,187082,324847,967142
2022-03-23,FINRA / Nasdaq TRF Chicago (DB),11223448,4115727,15787116,31126291,487843311.857300,135463932.392400,1089089254.027999,1712396498.277699,55393,13718,78622,147733
2022-03-23,FINRA / NYSE TRF (DN),273268533,159454740,527739603,960462876,10669291755.891300,5044188208.849201,22306887946.653486,38020367911.393987,1484895,324634,1656161,3465690
2022-03-23,FINRA / Nasdaq TRF Carteret (DQ),1458039312,804365252,1912611798,4175016362,68307760093.029168,44131567747.494503,93513838107.193980,205953165947.717651,7149493,2117170,7108884,16375547
2022-03-23,MIAX Pearl (H),42278927,34889769,36832905,114001601,1203528323.479800,2016120537.272400,2418870056.243200,5638518916.995400,390843,200291,361861,952995
2022-03-23,EDGA Equities (J),63092109,36719201,51067829,150879139,2484697257.465300,2031549977.997800,2767093960.760302,7283341196.223402,865761,246401,694209,1806371
2022-03-23,EDGX Equities (K),274889809,118096770,312498903,705485482,10906293791.768701,6021821738.487600,16505331603.223611,33433447133.479912,2306494,611813,2349836,5268143
2022-03-23,LTSE (L),25898,2300,20105,48303,837739.200000,3864.000000,2891327.050000,3732930.250000,22,1,116,139
2022-03-23,NYSE Chicago (M),13423575,11442493,10073599,34939667,1168187908.180600,1152726416.120100,1685982268.859100,4006896593.159800,80341,4458,80583,165382
2022-03-23,NYSE (N),944477179,47146532,75072456,1066696167,50588761591.157798,3184486067.996299,3609068204.317501,57382315863.471598,4207101,204448,595266,5006815
2022-03-23,NYSE Arca (P),231761717,340909838,356819277,929490832,9865210764.148103,21676095997.538191,19750534160.320396,51291840922.006690,2391929,1486928,3109991,6988848
2022-03-23,NASDAQ (Q),496001449,250568986,1060796778,1807367213,23638931376.444307,19080321519.058506,71100175621.750118,113819428517.252931,6376667,1706380,9330702,17413749
2022-03-23,Members Exchange (U),174010662,93891093,175750788,443652543,5194191271.923601,5299595139.766199,6157852470.877297,16651638882.567097,1479293,462392,1362195,3303880
2022-03-23,Investors Exchange (V),152542379,29328736,118890732,300761847,9243356913.482200,2158048964.443099,9128678693.239605,20530084571.164904,1903997,204265,1560382,3668644
2022-03-23,NASDAQ PSX (X),29765152,34528389,31126682,95420223,911951754.254200,2088312199.093400,1654249529.107701,4654513482.455301,268969,181653,335027,785649
2022-03-23,BYX Equities (Y),66254988,43558100,52288812,162101900,1855431452.944700,2685415422.103100,2229967585.336899,6770814460.384699,686947,227005,583230,1497182
2022-03-23,BZX Equities (Z),240440546,150470231,222373095,613283872,9920252408.056502,11160143381.830702,14815210426.154596,35895606216.041800,3049647,1011521,2765039,6826207
2022-03-22,NYSE American (A),15537055,32093292,14449778,62080125,738200613.766700,740753177.917000,664115247.969100,2143069039.652800,187203,116976,144270,448449
2022-03-22,NASDAQ BX (B),21978316,16003092,25149068,63130476,1144288224.741600,1336614490.958000,1665023272.704100,4145925988.403700,406465,129777,409261,945503
2022-03-22,NYSE National (C),43224230,32499781,29379429,105103440,1205573507.563200,1471738530.969500,945125730.287400,3622437768.820100,461678,185318,327978,974974
2022-03-22,FINRA / Nasdaq TRF Chicago (DB),10909754,3571777,14984310,29465841,479871890.582600,140542734.883400,1034941323.707000,1655355949.173000,56941,13082,78917,148940
2022-03-22,FINRA / NYSE TRF (DN),270692107,143837333,576994894,991524334,11569861434.801105,5354899888.607198,22642578656.662916,39567339980.071219,1414429,334138,1760380,3508947
2022-03-22,FINRA / Nasdaq TRF Carteret (DQ),1499046416,766138196,2042292663,4307477275,72415683493.437004,42452353294.111909,92641611599.147673,207509648386.696586,7198335,2106894,7372885,16678114
2022-03-22,MIAX Pearl (H),42337195,33424616,35833273,111595084,1283510967.353900,2303213220.275800,1943398116.875700,5530122304.505400,395678,199563,363148,958389
2022-03-22,EDGA Equities (J),64477177,35937273,53480447,153894897,2665961011.694900,1994605842.249100,2748622064.541400,7409188918.485400,869826,243015,716048,1828889
2022-03-22,EDGX Equities (K),267369401,104268501,337499936,709137838,10888517913.907096,5673165428.877200,16271276585.327096,32832959928.111392,2232744,569867,2358878,5161489
2022-03-22,LTSE (L),3345,6706,16617,26668,776132.890000,2975176.030000,158070.860000,3909379.780000,31,91,96,218
2022-03-22,NYSE Chicago (M),17698355,12818491,11866775,42383621,1157596585.254700,2076267844.241800,2151612596.693100,5385477026.189600,77221,4041,73867,155129
2022-03-22,NYSE (N),1069293961,42264990,72974831,1184533782,58738857566.422309,3357832320.603301,3547558348.837800,65644248235.863410,4241319,205685,610118,5057122
2022-03-22,NYSE Arca (P),230956003,335933622,420623644,987513269,9990070743.680803,21883856925.467099,20621207819.965599,52495135489.113501,2354844,1446591,3535926,7337361
2022-03-22,NASDAQ (Q),512925082,233701798,1183107265,1929734145,25478899736.641613,18553014055.002100,72474689162.433359,116506602954.077072,6554467,1683882,9027553,17265902
2022-03-22,Members Exchange (U),178319802,93041437,187768276,459129515,5387089027.877101,5224287116.615404,6005313475.183598,16616689619.676103,1495049,480053,1401404,3376506
2022-03-22,Investors Exchange (V),153544940,30348232,122932241,306825413,9448106762.260998,2155428281.264100,8994870803.672300,20598405847.197398,1875980,201187,1569988,3647155
2022-03-22,NASDAQ PSX (X),28908807,32430013,28995144,90333964,913748701.000800,2272083566.596399,1543844176.860600,4729676444.457799,264065,180269,324529,768863
2022-03-22,BYX Equities (Y),66896742,42096207,56792848,165785797,2006113349.153700,2848452137.697100,2224167018.960500,7078732505.811300,699221,228481,624304,1552006
2022-03-22,BZX Equities (Z),260729805,138770758,229963598,629464161,11213073242.963201,10329802097.931100,14664383786.668804,36207259127.563105,3255973,959038,2856288,7071299
2022-03-21,NYSE American (A),15817754,38244265,12227311,66289330,705399013.597900,785668130.179600,607649331.039700,2098716474.817200,191130,144575,138171,473876
2022-03-21,NASDAQ BX (B),21886484,19666083,25024673,66577240,1133386120.002500,1563691915.595400,1809795058.255000,4506873093.852900,402007,159399,409768,971174
2022-03-21,NYSE National (C),45543208,35334301,30289729,111167238,1277910182.913100,1573870898.806500,1017933284.007700,3869714365.727300,505797,209366,355468,1070631
2022-03-21,FINRA / Nasdaq TRF Chicago (DB),11252763,4323531,15562774,31139068,485433477.671800,160339765.538500,964357008.627800,1610130251.838100,56630,15172,77810,149612
2022-03-21,FINRA / NYSE TRF (DN),257136871,203604955,600747763,1061489589,11410934091.867404,5436622784.583198,21271503268.366700,38119060144.817302,1454088,381534,1834365,3669987
2022-03-21,FINRA / Nasdaq TRF Carteret (DQ),1509406513,888514803,2121086680,4519007996,75205361012.035409,41492750009.272713,93609845482.041103,210307956503.349225,7398839,2413876,7630101,17442816
2022-03-21,MIAX Pearl (H),47320888,44764689,36691860,128777437,1381801003.231400,2770695316.852400,1983623099.622300,6136119419.706100,417132,265984,368554,1051670
2022-03-21,EDGA Equities (J),67292473,44427792,57492482,169212747,2767154485.710900,2533993140.659399,2796225932.580800,8097373558.951099,901496,313956,750700,1966152
2022-03-21,EDGX Equities (K),272572523,155844350,361736316,790153189,11238910229.507702,6570783052.848799,15224701910.918196,33034395193.274697,2342549,722273,2462575,5527397
2022-03-21,LTSE (L),513,30400,9774,40687,326577.740000,24567.000000,159857.910000,511002.650000,6,4,157,167
2022-03-21,NYSE Chicago (M),22714478,9021740,17855934,49592152,1703416786.331300,1350618565.063200,2866408240.292000,5920443591.686500,92556,6628,85281,184465
2022-03-21,NYSE (N),1103147486,52485363,72306041,1227938890,59703570495.676705,3810887241.394199,3525579679.880202,67040037416.951106,4711741,253330,638551,5603622
2022-03-21,NYSE Arca (P),240107635,428513438,435511255,1104132328,10439224285.250702,25912349792.095006,20644808995.279495,56996383072.625203,2512569,1872721,3697256,8082546
2022-03-21,NASDAQ (Q),541606947,297838580,1238681510,2078127037,26591514940.111300,22745457880.313091,72227825866.895712,121564798687.320103,6984017,2097008,9755966,18836991
2022-03-21,Members Exchange (U),184609159,123741549,186937355,495288063,5722534819.400003,6546405796.436203,6102336197.834498,18371276813.670704,1611711,606541,1457125,3675377
2022-03-21,Investors Exchange (V),162049313,36069785,126381122,324500220,9816801531.289703,2701403939.192500,8764383170.976202,21282588641.458405,2085743,232585,1765023,4083351
2022-03-21,NASDAQ PSX (X),27928221,35722863,32071468,95722552,849948283.298900,2395814254.923601,1566817037.117000,4812579575.339501,275962,202037,340259,818258
2022-03-21,BYX Equities (Y),68178397,50161632,58010746,176350775,1989900057.124000,3459769191.833498,2193686315.589900,7643355564.547398,708722,287583,624951,1621256
2022-03-21,BZX Equities (Z),271250180,181940569,245315412,698506161,11526745371.069200,13024620566.432792,14454630810.868798,39005996748.370790,3389293,1232195,3029149,7650637
2022-03-18,NYSE American (A),19465518,119212211,15209693,153887422,913633154.648000,1553134994.408900,911756302.003300,3378524451.060200,241074,137212,185077,563363
2022-03-18,NASDAQ BX (B),26568428,21058844,29691238,77318510,1223517105.029300,1721731050.798400,2013675057.615100,4958923213.442800,440990,170741,458967,1070698
2022-03-18,NYSE National (C),56463145,40626523,36270598,133360266,1493851477.640500,1872127495.384300,1381441653.343000,4747420626.367800,604097,218882,416274,1239253
2022-03-18,FINRA / Nasdaq TRF Chicago (DB),13315917,3687090,16663627,33666634,438396698.563900,117018431.844300,925610119.843500,1481025250.251700,56091,14319,79964,150374
2022-03-18,FINRA / NYSE TRF (DN),304554490,152938708,593467946,1050961144,11022652309.961002,5416357977.809000,23105014758.392106,39544025046.162108,1400798,342693,1770333,3513824
2022-03-18,FINRA / Nasdaq TRF Carteret (DQ),2095743133,887480484,2640480395,5623704012,92376029790.726080,55544091838.677098,114817475148.172088,262737596777.575266,7740971,2281377,8087487,18109835
2022-03-18,MIAX Pearl (H),69324710,43498720,42673029,155496459,1631634517.602300,2758884943.075200,2283600028.065000,6674119488.742500,462222,262550,412539,1137311
2022-03-18,EDGA Equities (J),80333559,46952652,68640832,195927043,2935697615.207200,2731318875.603900,3347029015.915100,9014045506.726200,1036656,334027,863951,2234634
2022-03-18,EDGX Equities (K),318288794,130043629,373019784,821352207,11347586279.533097,7177751435.857198,16349585639.128699,34874923354.518994,2534521,704735,2601453,5840709
2022-03-18,LTSE (L),184825,1300,33625,219750,3674317.350000,7454.000000,1233172.350000,4914943.700000,316,3,126,445
2022-03-18,NYSE Chicago (M),18147001,18951566,21384053,58482620,1321316367.461700,2945314239.416800,4847765422.099300,9114396028.977800,83175,5919,85131,174225
2022-03-18,NYSE (N),3437980748,56213127,84371807,3578565682,179540068305.698815,4228451506.749500,4142857586.666600,187911377399.114915,5136436,261199,729020,6126655
2022-03-18,NYSE Arca (P),293543752,417580846,474102940,1185227538,12054417650.703499,28237733014.840700,23883516435.636994,64175667101.181193,2902969,1827676,4091775,8822420
2022-03-18,NASDAQ (Q),650205507,301855690,2956327769,3908388966,30188264124.066804,24155600924.764896,162083717796.001495,216427582844.833195,7860524,2119844,11033415,21013783
2022-03-18,Members Exchange (U),221881424,121027903,215679656,558588983,6290787539.690100,6775441623.980700,7157562757.951699,20223791921.622499,1800893,615907,1669729,4086529
2022-03-18,Investors Exchange (V),217443762,44198585,171082328,432724675,11599196795.863898,3102728194.054900,11103145780.185098,25805070770.103896,2393469,268418,2029367,4691254
2022-03-18,NASDAQ PSX (X),35633339,39311324,37100237,112044900,1134135078.074900,3015336733.978101,2236323631.145701,6385795443.198702,355211,224566,411140,990917
2022-03-18,BYX Equities (Y),88509141,54837314,70766152,214112607,2327524399.247000,3428537981.313399,2738926527.777700,8494988908.338099,836833,294066,731396,1862295
2022-03-18,BZX Equities (Z),330846137,186044412,302330030,819220579,13871979263.047506,12992743477.216397,19199775012.305699,46064497752.569602,3972529,1212955,3607326,8792810
2022-03-17,NYSE American (A),17015971,37461451,12446142,66923564,757780908.914800,966811330.717900,611538026.289400,2336130265.922100,199517,138211,143082,480810
2022-03-17,NASDAQ BX (B),24176734,21504701,25156616,70838051,1174964522.974200,1598026309.147300,1484117358.360700,4257108190.482200,434106,171956,406051,1012113
2022-03-17,NYSE National (C),47487242,39193780,31077441,117758463,1194861307.537800,1716425600.776900,920256408.574300,3831543316.889000,505564,217656,351412,1074632
2022-03-17,FINRA / Nasdaq TRF Chicago (DB),11018035,4389755,15862968,31270758,417084821.181800,138160691.954600,819050591.410100,1374296104.546500,52311,16095,69573,137979
2022-03-17,FINRA / NYSE TRF (DN),258121500,172701604,559089737,989912841,10258086426.415001,5397028907.746096,18133779076.569508,33788894410.730605,1322352,354813,1608872,3286037
2022-03-17,FINRA / Nasdaq TRF Carteret (DQ),1495962920,831986997,2056300575,4384250492,69378273184.055365,48920759238.590512,82228515013.475521,200527547436.121398,7508707,2287377,7423197,17219281
2022-03-17,MIAX Pearl (H),44310043,44871762,36873319,126055124,1300064933.596000,2526587784.330400,1668937577.565100,5495590295.491500,399896,263198,344537,1007631
2022-03-17,EDGA Equities (J),69993499,47414574,57022573,174430646,2659898366.215000,2648605862.522400,2773621971.918000,8082126200.655400,949188,341421,765050,2055659
2022-03-17,EDGX Equities (K),270502491,138176355,353061830,761740676,10437572939.533598,6922368682.500499,14052550206.473205,31412491828.507302,2358025,736558,2342279,5436862
2022-03-17,LTSE (L),62620,4481,15736,82837,1359289.770000,1836854.190000,1131845.470000,4327989.430000,32,55,185,272
2022-03-17,NYSE Chicago (M),13153556,17370285,10999470,41523311,1162621143.989100,2077529777.944200,1906861678.877299,5147012600.810599,72107,5082,62202,139391
2022-03-17,NYSE (N),1106461383,53078104,76087199,1235626686,57251920526.623796,3655249215.354902,3397312691.330701,64304482433.309399,4776788,250822,683528,5711138
2022-03-17,NYSE Arca (P),250456558,399955430,444749973,1095161961,10674123699.154501,25749964876.381603,19513187698.476104,55937276274.012208,2690025,1885148,3700919,8276092
2022-03-17,NASDAQ (Q),581680166,310048275,1237673313,2129401754,27632607095.881397,24466422729.247590,69740491777.243275,121839521602.372262,7545936,2229608,9882716,19658260
2022-03-17,Members Exchange (U),207041901,125032588,203210352,535284841,5823004435.167799,6716010646.373800,5874023103.498403,18413038185.040002,1704997,641874,1492080,3838951
2022-03-17,Investors Exchange (V),187946587,43859926,147791155,379597668,10459995842.323399,3112308711.021099,9476642941.714599,23048947495.059097,2237651,269380,1845410,4352441
2022-03-17,NASDAQ PSX (X),27585554,37257528,28227894,93070976,857755846.718200,2740822116.598900,1402151041.197200,5000729004.514300,284304,210509,312650,807463
2022-03-17,BYX Equities (Y),75341861,52135905,60105563,187583329,2019357672.536000,3327506491.167899,2178956239.353000,7525820403.056899,768978,284868,635600,1689446
2022-03-17,BZX Equities (Z),296781170,184767527,256341783,737890480,12563799103.978599,13073079052.871201,14796331275.602198,40433209432.451998,3665719,1240607,3118254,8024580
2022-03-16,NYSE American (A),21076389,39249659,16135236,76461284,919393047.861400,1290477594.746400,1032421158.195900,3242291800.803700,248618,155619,188796,593033
2022-03-16,NASDAQ BX (B),29755377,32162884,33109310,95027571,1362869414.767000,2487272600.392100,2113550045.410899,5963692060.569999,533116,240294,545783,1319193
2022-03-16,NYSE National (C),58234613,46504746,37383134,142122493,1449549780.464700,2043470012.250400,1226056523.583400,4719076316.298500,596892,252531,427794,1277217
2022-03-16,FINRA / Nasdaq TRF Chicago (DB),13713302,4047613,15967167,33728082,460858642.025100,147745136.644700,940265062.698800,1548868841.368600,59669,15381,76591,151641
2022-03-16,FINRA / NYSE TRF (DN),317631938,163950663,593380507,1074963108,11478679390.810103,6012429590.040603,22995980147.505668,40487089128.356374,1540108,387267,1784338,3711713
2022-03-16,FINRA / Nasdaq TRF Carteret (DQ),1841687291,943253461,2290051415,5074992167,78701988849.302504,55426259596.610582,103523148104.024401,237651396549.937487,8541979,2683102,8429383,19654464
2022-03-16,MIAX Pearl (H),65854317,60117106,45603814,171575237,1642382799.976300,3496931044.080301,2361499846.214500,7500813690.271101,502736,329842,413167,1245745
2022-03-16,EDGA Equities (J),92596542,65764937,74696547,233058026,3278769411.943000,3832789543.072299,3845692515.162900,10957251470.178199,1125399,466704,936391,2528494
2022-03-16,EDGX Equities (K),360547609,175514463,387412903,923474975,12329581946.045299,10814631400.689605,17760583552.083908,40904796898.818812,2884149,1046778,2828670,6759597
2022-03-16,LTSE (L),30305,16379,101209,147893,747801.010000,6993341.720000,4477031.540000,12218174.270000,17,205,151,373
2022-03-16,NYSE Chicago (M),18507486,22551854,17828819,58888159,1753238891.018400,2393223969.317500,2856889655.036400,7003352515.372300,143305,6423,122337,272065
2022-03-16,NYSE (N),1350446446,76867526,91515541,1518829513,65725007817.239705,5742992178.856900,4365570240.002599,75833570236.099204,5977335,362295,836509,7176139
2022-03-16,NYSE Arca (P),341090699,598731696,549458973,1489281368,12895055840.416200,38909810156.547108,27747914525.560607,79552780522.523915,3380900,2805560,4724960,10911420
2022-03-16,NASDAQ (Q),783766239,443987682,1561098274,2788852195,35027537436.232300,36404636267.475188,92925061133.724484,164357234837.431972,9568163,3281542,12775647,25625352
2022-03-16,Members Exchange (U),269363571,176308024,224480976,670152571,7281409044.836599,9721175265.953099,8117374675.406002,25119958986.195700,2181059,878432,1846315,4905806
2022-03-16,Investors Exchange (V),236668821,53894050,182599549,473162420,13117029408.910799,3809502039.691599,12301467792.420898,29227999241.023296,2652746,311122,2222498,5186366
2022-03-16,NASDAQ PSX (X),34751009,47667283,34510417,116928709,1004794429.456300,3275088584.710300,2017963906.551200,6297846920.717800,314706,270123,367715,952544
2022-03-16,BYX Equities (Y),96080461,68990826,67418251,232489538,2431771308.592600,4570717120.533900,2786240274.967901,9788728704.094401,889274,364136,728789,1982199
2022-03-16,BZX Equities (Z),377951781,271839668,329467531,979258980,14673440369.703400,20388707890.333300,21042369929.982809,56104518190.019509,4461753,1864194,3994357,10320304
2022-03-15,NYSE American (A),19821066,37576199,13980912,71378177,811195924.474700,1208974417.983000,846654627.634000,2866824970.091700,220944,148106,155488,524538
2022-03-15,NASDAQ BX (B),25597194,26541882,26617768,78756844,1131418129.005400,1806893002.283301,1645489582.513600,4583800713.802301,440929,197803,429946,1068678
2022-03-15,NYSE National (C),52289841,46834081,33325854,132449776,1236420701.106200,1891806390.064900,1026813234.074800,4155040325.245900,536750,243703,363687,1144140
2022-03-15,FINRA / Nasdaq TRF Chicago (DB),12469264,3803095,16038564,32310923,339414532.265800,143366280.680200,741582723.362000,1224363536.308000,50733,14573,68813,134119
2022-03-15,FINRA / NYSE TRF (DN),261510896,156096669,512046228,929653793,8692751351.871203,5331964263.700700,17491575990.365888,31516291605.937791,1318130,356621,1585578,3260329
2022-03-15,FINRA / Nasdaq TRF Carteret (DQ),1632775325,952674274,1994573489,4580023088,67059925468.910084,54004751529.013191,84757366121.916960,205822043119.840235,7607215,2514560,7405573,17527348
2022-03-15,MIAX Pearl (H),47630252,52417540,36196758,136244550,1308195076.446900,3083007833.560999,1947445709.048301,6338648619.056200,427118,288986,351991,1068095
2022-03-15,EDGA Equities (J),78111474,56021240,61248365,195381079,2762084484.178000,2946285296.392900,3005840401.303600,8714210181.874500,1005968,399487,814060,2219515
2022-03-15,EDGX Equities (K),281225054,152992531,304119824,738337409,9412827088.696000,8157003386.115600,13302194952.888301,30872025427.699901,2403382,892461,2351774,5647617
2022-03-15,LTSE (L),1761,0,18354,20115,660923.130000,0.000000,3425226.850000,4086149.980000,25,0,132,157
2022-03-15,NYSE Chicago (M),11619186,8815020,12466773,32900979,1012478605.144600,1542422463.836300,2097617341.641299,4652518410.622199,93204,6747,69897,169848
2022-03-15,NYSE (N),1175073755,69322293,77395168,1321791216,58038828033.822495,4268987658.688000,3532563890.607700,65840379583.118195,5382076,307553,708539,6398168
2022-03-15,NYSE Arca (P),283827576,492907337,420508376,1197243289,10461424155.586301,31332270055.684986,20746913959.862803,62540608171.134090,2843800,2264993,3918867,9027660
2022-03-15,NASDAQ (Q),661652299,361621431,1240261630,2263535360,29058858547.440200,27045515409.512700,75654616337.106118,131758990294.059018,8223693,2731768,10844384,21799845
2022-03-15,Members Exchange (U),222816303,136135400,191204127,550155830,5998162954.525600,7105057704.052200,6290256515.718298,19393477174.296098,1840364,708765,1523608,4072737
2022-03-15,Investors Exchange (V),196118211,46551175,151411485,394080871,10490564733.719801,3360891464.228201,9621430830.247297,23472887028.195299,2279893,281148,1840923,4401964
2022-03-15,NASDAQ PSX (X),30800205,44884414,29986473,105671092,870069962.909100,2270852423.017000,1717185824.324700,4858108210.250800,297566,254098,341170,892834
2022-03-15,BYX Equities (Y),87430724,64947108,61041544,213419376,2109062745.250900,3773255505.054101,2277829540.179600,8160147790.484601,832782,351824,665857,1850463
2022-03-15,BZX Equities (Z),311702537,223490520,257664430,792857487,12021483037.245898,15551290629.374598,14856243554.212302,42429017220.832798,3783599,1538587,3221930,8544116
2022-03-14,NYSE American (A),23136659,39196738,16379104,78712501,918313699.623400,1091719213.399300,850300521.379900,2860333434.402600,264985,162943,193592,621520
2022-03-14,NASDAQ BX (B),31832300,24784968,29380750,85998018,1283096507.250200,1519879592.947600,1729561331.390000,4532537431.587800,500307,196170,478861,1175338
2022-03-14,NYSE National (C),59240331,47591794,38118017,144950142,1412561165.631300,1860735918.483800,1113607337.992600,4386904422.107700,590372,273980,412500,1276852
2022-03-14,FINRA / Nasdaq TRF Chicago (DB),13471886,4498544,19088182,37058612,398176715.621200,166063256.855700,847947976.867500,1412187949.344400,57285,16260,81082,154627
2022-03-14,FINRA / NYSE TRF (DN),261226874,171250478,549113063,981590415,8928299696.595797,5709316744.554501,16706725714.675900,31344342155.826198,1487704,406688,1808216,3702608
2022-03-14,FINRA / Nasdaq TRF Carteret (DQ),1643935645,933516105,2097647879,4675099629,68889765721.218035,48154941603.123013,84713240291.569361,201757947615.910409,8141784,2738835,8347982,19228601
2022-03-14,MIAX Pearl (H),51174308,52603602,43277378,147055288,1442352987.278500,2684026766.659400,2314142937.589400,6440522691.527300,454467,301252,397686,1153405
2022-03-14,EDGA Equities (J),87476141,55079569,69063668,211619378,2983793975.526400,2874307972.783900,3230830911.474000,9088932859.784300,1093063,415026,903299,2411388
2022-03-14,EDGX Equities (K),295162910,155909133,356829940,807901983,9883356131.422801,7819061546.296203,13786062102.769905,31488479780.488909,2675734,937590,2734002,6347326
2022-03-14,LTSE (L),45617,32043,30570,108230,2660662.780000,11041411.620000,2854985.650000,16557060.050000,30,327,172,529
2022-03-14,NYSE Chicago (M),24183123,10801825,13066603,48051551,1612165273.909300,1182293698.262300,2000774528.454500,4795233500.626100,89997,6017,72344,168358
2022-03-14,NYSE (N),1191848173,72191763,85441913,1349481849,57739196009.070902,4419196363.283200,3920471458.436700,66078863830.790802,5665571,332991,796725,6795287
2022-03-14,NYSE Arca (P),286751677,493628537,465232456,1245612670,10859831015.757703,30890014627.149904,22643706327.966697,64393551970.874304,3007160,2436125,4473876,9917161
2022-03-14,NASDAQ (Q),686728830,368220759,1324242377,2379191966,30084386810.776698,27387368709.881505,75667287865.290193,133139043385.948396,8660366,2891353,11763619,23315338
2022-03-14,Members Exchange (U),238608494,147545642,213892637,600046773,6245238923.053998,7470351794.188403,6745332909.272700,20460923626.515101,1921682,779909,1694308,4395899
2022-03-14,Investors Exchange (V),213270773,48267739,169631543,431170055,11465589217.248999,3354577011.877800,11214744364.932504,26034910594.059303,2394421,284317,2052764,4731502
2022-03-14,NASDAQ PSX (X),33454472,45645481,34236788,113336741,954945920.941600,2281413705.039600,1783050641.465400,5019410267.446600,318024,252050,380894,950968
2022-03-14,BYX Equities (Y),94228475,62244381,66823889,223296745,2294933912.610900,3521984519.514599,2435690725.136601,8252609157.262100,878248,335790,719457,1933495
2022-03-14,BZX Equities (Z),339143541,220104642,285217068,844465251,12812495809.126301,16124487982.333001,15505953423.581498,44442937215.040800,4075437,1605001,3564093,9244531
2022-03-11,NYSE American (A),19122075,41059668,14935973,75117716,807023664.753500,933569537.270300,728762597.564400,2469355799.588200,217173,159432,152553,529158
2022-03-11,NASDAQ BX (B),25859025,20757489,23202715,69819229,1122874134.780400,1524254198.789100,1414597925.967000,4061726259.536500,417121,164994,381453,963568
2022-03-11,NYSE National (C),52470555,41189541,28946384,122606480,1245857977.115900,1702909670.181000,846952198.167600,3795719845.464500,529249,253755,336552,1119556
2022-03-11,FINRA / Nasdaq TRF Chicago (DB),11991431,4422007,15501877,31915315,365919407.340000,129308243.942300,745463645.450700,1240691296.733000,49109,16728,72563,138400
2022-03-11,FINRA / NYSE TRF (DN),254412129,198109895,518412229,970934253,8262854414.132801,4915151905.000901,16258786655.244721,29436792974.378423,1281494,402342,1623641,3307477
2022-03-11,FINRA / Nasdaq TRF Carteret (DQ),1517389764,987574485,1968377880,4473342129,61074082638.568200,46935798958.041662,75437456682.210110,183447338278.819972,7123031,2487716,7309009,16919756
2022-03-11,MIAX Pearl (H),47484032,44209105,37557202,129250339,1230554088.846100,2140379777.867500,2705938895.429100,6076872762.142700,393536,248812,341183,983531
2022-03-11,EDGA Equities (J),75078478,60099961,54088583,189267022,2635153334.032000,3003474841.085000,2641356473.116800,8279984648.233800,954778,454337,739697,2148812
2022-03-11,EDGX Equities (K),271475134,166607021,328176736,766258891,9068260408.126394,7294934933.500508,13381318060.625691,29744513402.252593,2339646,855810,2393988,5589444
2022-03-11,LTSE (L),168,0,28682,28850,334369.900000,0.000000,656200.223500,990570.123500,10,0,346,356
2022-03-11,NYSE Chicago (M),10805135,5663704,11346631,27815470,866651611.640600,1014915153.672400,1628013162.747399,3509579928.060399,73164,4747,58674,136585
2022-03-11,NYSE (N),1029560809,63010455,70692713,1163263977,50668758512.867902,3954443344.425900,3513990998.883201,58137192856.177003,4850332,295377,668220,5813929
2022-03-11,NYSE Arca (P),253234321,498045861,424138993,1175419175,9864511557.030699,31798445644.579276,20480691362.813395,62143648564.423370,2632765,2267802,3794626,8695193
2022-03-11,NASDAQ (Q),587237907,337860140,1143692734,2068790781,25983464034.864095,25423256467.449894,67197845722.362568,118604566224.676557,7315903,2480296,9748583,19544782
2022-03-11,Members Exchange (U),213867346,135842173,189500866,539210385,5808959828.729000,6969283808.240300,6142377999.784100,18920621636.753400,1757305,713359,1507582,3978246
2022-03-11,Investors Exchange (V),174448018,40635764,131422157,346505939,9679004269.981801,2844722598.134300,8631243861.900601,21154970730.016702,2054092,248415,1635907,3938414
2022-03-11,NASDAQ PSX (X),27643475,41208462,27767319,96619256,788523676.178500,2126580647.796700,1403718156.084900,4318822480.060100,274939,219088,327657,821684
2022-03-11,BYX Equities (Y),84034645,56163939,56392774,196591358,1984559027.644900,3295411417.452800,2049954682.592000,7329925127.689700,798138,311348,617565,1727051
2022-03-11,BZX Equities (Z),282528631,197094366,244031268,723654265,11051650211.139999,15016091961.456604,14158771383.312794,40226513555.909397,3443325,1454389,3006526,7904240
2022-03-10,NYSE American (A),18338909,38426858,13543196,70308963,834869622.403800,946170297.627500,792974659.737000,2574014579.768300,227629,151729,153788,533146
2022-03-10,NASDAQ BX (B),25566911,21326770,23171183,70064864,1163699154.878800,1541533008.810899,1615593530.133600,4320825693.823299,433021,163175,384383,980579
2022-03-10,NYSE National (C),53016682,41734272,28579639,123330593,1308780815.179700,1752652756.710500,1038618233.060300,4100051804.950500,550530,249227,340215,1139972
2022-03-10,FINRA / Nasdaq TRF Chicago (DB),10307866,3623000,13374725,27305591,401775930.298600,141956543.475900,825112979.859900,1368845453.634400,48095,14514,70469,133078
2022-03-10,FINRA / NYSE TRF (DN),250872803,176910356,491962617,919745776,9231094913.197806,5373824497.080899,17438877539.787189,32043796950.065894,1299768,390460,1561707,3251935
2022-03-10,FINRA / Nasdaq TRF Carteret (DQ),1548098708,905096612,1905112846,4358308166,69239780566.815104,45713374033.787698,85430360428.413654,200383515029.016456,7502138,2461983,7341855,17305976
2022-03-10,MIAX Pearl (H),38382960,41107699,34772413,114263072,1260198848.340000,1990023213.577000,1757367735.042700,5007589796.959700,386581,230061,312806,929448
2022-03-10,EDGA Equities (J),73578388,60123725,56411139,190113252,2795869045.120000,3032161322.910599,2854897131.818600,8682927499.849199,993910,452555,747789,2194254
2022-03-10,EDGX Equities (K),273408844,147817282,306250663,727476789,9974122675.826799,7494075556.433401,14291646372.440995,31759844604.701195,2496168,847862,2410564,5754594
2022-03-10,LTSE (L),97038,3608,18916,119562,3931852.290000,122061.390000,663302.180000,4717215.860000,215,17,197,429
2022-03-10,NYSE Chicago (M),9779529,10759184,10676038,31214751,780129919.830100,1607530446.944400,1607466288.282800,3995126655.057300,91406,4950,73750,170106
2022-03-10,NYSE (N),1025718554,58911022,70095581,1154725157,51878105166.341689,3508903676.410498,3831132730.852899,59218141573.605086,5072361,273302,686273,6031936
2022-03-10,NYSE Arca (P),255542674,455272901,414665266,1125480841,10467254657.416299,31026153736.672508,22299233069.483601,63792641463.572408,2798667,2219623,3903315,8921605
2022-03-10,NASDAQ (Q),593649327,339679975,1075953036,2009282338,28079808354.173300,25470046926.598822,67318299792.105087,120868155072.877209,7840796,2508006,9879441,20228243
2022-03-10,Members Exchange (U),220156529,135347245,180533295,536037069,6252037847.526399,6823063672.939201,6299992669.800699,19375094190.266299,1855026,711456,1526138,4092620
2022-03-10,Investors Exchange (V),182224867,41135434,127356825,350717126,10530101905.900799,2957857620.938001,8901528090.583999,22389487617.422799,2149899,256552,1626935,4033386
2022-03-10,NASDAQ PSX (X),29098452,37231355,27380614,93710421,910376943.481100,1941080494.660299,1614999599.364000,4466457037.505399,289511,201126,318096,808733
2022-03-10,BYX Equities (Y),79868161,51819558,53788840,185476559,2172305139.921000,3342085379.439899,2341633580.113800,7856024099.474699,813566,292437,602590,1708593
2022-03-10,BZX Equities (Z),293125860,199062888,237603392,729792140,11894329498.321702,15615712277.081401,15462663071.940499,42972704847.343602,3653519,1470950,3049337,8173806
2022-03-09,NYSE American (A),21485007,46743393,12817562,81045962,1015410640.676000,1404775007.548199,857587202.255500,3277772850.479699,255331,186332,162628,604291
2022-03-09,NASDAQ BX (B),29045218,26665367,24731323,80441908,1457685161.547100,2047820744.747400,1659729511.410200,5165235417.704700,506747,202919,427266,1136932
2022-03-09,NYSE National (C),56091067,53022260,33921919,143035246,1512924223.255500,2164740006.364900,1139877646.969800,4817541876.590200,629276,297733,403142,1330151
2022-03-09,FINRA / Nasdaq TRF Chicago (DB),10731493,3590523,14975904,29297920,433895479.817300,152837297.442100,743965770.452000,1330698547.711400,54199,16250,71572,142021
2022-03-09,FINRA / NYSE TRF (DN),269582430,203339203,487890143,960811776,10515706698.089895,6305390881.599397,17131997117.492989,33953094697.182281,1353278,436970,1548977,3339225
2022-03-09,FINRA / Nasdaq TRF Carteret (DQ),1728357098,1020270923,1999174720,4747802741,78584411327.534703,51723860985.135731,84959477424.272898,215267749736.943332,8300645,2650360,7599095,18550100
2022-03-09,MIAX Pearl (H),44848020,47484189,30848632,123180841,1445808477.014700,2254909041.000200,1807751053.388700,5508468571.403600,440461,251341,331768,1023570
2022-03-09,EDGA Equities (J),83732230,74418235,58233016,216383481,3158745361.552700,4013727719.527000,2889632430.331300,10062105511.411000,1114506,532040,797726,2444272
2022-03-09,EDGX Equities (K),306645158,180649089,318444070,805738317,11440311513.139300,9789995997.216096,14340831296.115796,35571138806.471192,2702864,1004735,2487695,6195294
2022-03-09,LTSE (L),17661,8208,14993,40862,1251417.490000,525411.120000,362763.020000,2139591.630000,176,71,168,415
2022-03-09,NYSE Chicago (M),14624785,12087312,10002534,36714631,1236869201.298700,929977598.265300,1169880469.247300,3336727268.811300,109750,6851,80088,196689
2022-03-09,NYSE (N),1195112444,80165615,76056798,1351334857,61485573180.795604,5164080156.341298,3534716440.860802,70184369777.997704,5683640,357609,713077,6754326
2022-03-09,NYSE Arca (P),295585972,545301273,427383383,1268270628,12360066967.967701,36440095913.337175,23661392225.882891,72461555107.187767,3160255,2575761,4103436,9839452
2022-03-09,NASDAQ (Q),693046804,411127382,1233762045,2337936231,32766428173.609999,31798829099.316402,76526494756.409485,141091752029.335886,8808534,2986521,10545032,22340087
2022-03-09,Members Exchange (U),251846913,175782761,186331071,613960745,7404071796.914100,9029850813.791100,6613903475.465998,23047826086.171198,2092866,866053,1575352,4534271
2022-03-09,Investors Exchange (V),204308447,46746628,141060958,392116033,12108891481.124400,3255570857.529799,9962175117.539102,25326637456.193301,2502209,283823,1815319,4601351
2022-03-09,NASDAQ PSX (X),34349966,52670618,29293243,116313827,1187701822.710000,3168814978.467100,1560267578.801901,5916784379.979001,351296,289721,332159,973176
2022-03-09,BYX Equities (Y),79635523,63062182,56408043,199105748,2322728176.320300,3958694635.835601,2369953892.555902,8651376704.711803,840737,341144,639524,1821405
2022-03-09,BZX Equities (Z),343625400,243100896,255206452,841932748,14113579072.961900,18986199615.500096,15714459189.644599,48814237878.106595,4199575,1705043,3279308,9183926
2022-03-08,NYSE American (A),29842624,87866495,18303716,136012835,1283341022.257300,2078391380.239601,1028671636.111300,4390404038.608201,317974,285627,208598,812199
2022-03-08,NASDAQ BX (B),37953314,38235700,34802578,110991592,1820706530.219000,2625188262.510801,2258251755.851900,6704146548.581701,628956,309890,543042,1481888
2022-03-08,NYSE National (C),69959400,65432017,39414883,174806300,1658690705.060100,2369383862.097500,1280025315.516099,5308099882.673699,695139,345197,420431,1460767
2022-03-08,FINRA / Nasdaq TRF Chicago (DB),14586209,7278065,20085275,41949549,539989106.186300,250129459.123800,1080690367.007500,1870808932.317600,62026,23761,81155,166942
2022-03-08,FINRA / NYSE TRF (DN),348858879,396524019,611743157,1357126055,12462215716.316602,8208524264.086102,21393777199.872789,42064517180.275493,1712927,708419,1878857,4300203
2022-03-08,FINRA / Nasdaq TRF Carteret (DQ),2149423295,1662818534,2358423636,6170665465,94524122978.384727,68517641813.296494,104984104995.248681,268025869786.929902,9978766,4130104,8827194,22936064
2022-03-08,MIAX Pearl (H),64828134,77406142,44465018,186699294,1932167609.216800,3679159085.631099,2771184963.542900,8382511658.390799,562612,422791,448889,1434292
2022-03-08,EDGA Equities (J),98179530,113790481,75145157,287115168,3619196929.545500,5871690879.247501,4235394619.203099,13726282427.996100,1266050,808170,982497,3056717
2022-03-08,EDGX Equities (K),404751425,320900115,407671649,1133323189,13808229315.288497,13826755453.349410,18248567113.999790,45883551882.637697,3296266,1603850,3127335,8027451
2022-03-08,LTSE (L),8099,397951,34552,440602,701419.790000,13016665.960000,3804759.100000,17522844.850000,73,264,121,458
2022-03-08,NYSE Chicago (M),18733766,11327101,14030095,44090962,1768155652.405300,1053553452.015100,2322863186.004802,5144572290.425202,181923,8644,140042,330609
2022-03-08,NYSE (N),1523564867,147192569,113580123,1784337559,72956157373.265216,8330233929.634603,4819904339.492298,86106295642.392117,7382178,521163,867206,8770547
2022-03-08,NYSE Arca (P),393619892,814774343,557869485,1766263720,15338354465.706598,49850863768.536380,29922687192.292201,95111905426.535179,3901529,3871832,5198091,12971452
2022-03-08,NASDAQ (Q),895464091,644087378,1508468342,3048019811,40257634676.022194,46507634683.817601,92328476875.614680,179093746235.454475,10843664,4665042,13672321,29181027
2022-03-08,Members Exchange (U),319625863,303031962,241051350,863709175,8661240275.118902,14113613491.815499,8951018321.382304,31725872088.316705,2428021,1315426,1880255,5623702
2022-03-08,Investors Exchange (V),255544398,69543354,173536342,498624094,14695167535.317600,4464702070.900402,11922767497.184102,31082637103.402104,3016694,414563,2135614,5566871
2022-03-08,NASDAQ PSX (X),49493595,80881826,43198904,173574325,1436611998.277800,3938582268.124101,2326309762.592300,7701504028.994201,390017,428987,406674,1225678
2022-03-08,BYX Equities (Y),110426976,89875923,71218460,271521359,2972856880.711500,5079514718.138898,2921701165.636600,10974072764.486998,1037304,486075,768429,2291808
2022-03-08,BZX Equities (Z),458259801,385310926,350920797,1194491524,17509409871.573597,29715329129.895900,21930859070.093496,69155598071.562993,5008746,2685701,4222919,11917366
2022-03-07,NYSE American (A),28165902,78164225,18918299,125248426,1307834720.864400,1877245799.475000,1054653251.796400,4239733772.135800,309286,266365,203380,779031
2022-03-07,NASDAQ BX (B),36871909,30551588,30215135,97638632,1804857640.218700,2054502976.716900,2053341311.839600,5912701928.775200,593773,244055,497343,1335171
2022-03-07,NYSE National (C),65635398,58057142,38439772,162132312,1681475022.816900,2350147582.269100,1213986355.669400,5245608960.755400,691864,341618,434970,1468452
2022-03-07,FINRA / Nasdaq TRF Chicago (DB),14122409,6760354,16698021,37580784,518308015.400500,205973797.597000,864382069.477400,1588663882.474900,65137,25368,74795,165300
2022-03-07,FINRA / NYSE TRF (DN),340683597,332143465,564783514,1237610576,12216168271.098903,7403021747.442700,18270226127.217296,37889416145.758899,1885250,697982,1957574,4540806
2022-03-07,FINRA / Nasdaq TRF Carteret (DQ),2131432830,1500478187,2172192110,5804103127,95669927817.587933,63267079892.037695,93521693158.305911,252458700867.931539,10632056,4034320,9037046,23703422
2022-03-07,MIAX Pearl (H),56150331,59330704,37710098,153191133,1769215302.463600,2840152430.982500,2115793293.085300,6725161026.531400,518373,309715,403497,1231585
2022-03-07,EDGA Equities (J),97432655,89927132,74347637,261707424,3813031484.015500,4572131001.046799,3903936859.507800,12289099344.570099,1282473,637118,987551,2907142
2022-03-07,EDGX Equities (K),387945323,258883604,377946052,1024774979,14143609919.532502,10832212867.099398,16642812948.527891,41618635735.159791,3443126,1315338,3051124,7809588
2022-03-07,LTSE (L),37852,5895,2709,46456,1066875.160000,70492.190000,220543.690000,1357911.040000,33,14,13,60
2022-03-07,NYSE Chicago (M),13860227,10271630,10732031,34863888,1013841839.333800,1410886084.646700,1742495908.794900,4167223832.775400,78251,7745,54984,140980
2022-03-07,NYSE (N),1394821946,109136274,108770983,1612729203,70608696287.217995,6394027082.206799,4801319168.657099,81804042538.081893,6683575,411915,851641,7947131
2022-03-07,NYSE Arca (P),381115140,681716476,509375979,1572207595,15450212141.124597,41783521931.862402,26888058218.468000,84121792291.454999,3796532,3242963,4888439,11927934
2022-03-07,NASDAQ (Q),858481207,495442994,1435171342,2789095543,40556391022.073903,36192414626.556015,89195272429.236087,165944078077.866005,10512125,3601765,12889220,27003110
2022-03-07,Members Exchange (U),301582038,237581562,216079186,755242786,8547186325.686000,11018057116.280299,7851950060.935800,27417193502.902099,2356776,1049982,1803988,5210746
2022-03-07,Investors Exchange (V),258215048,61792670,165013932,485021650,15458951690.370997,3958572118.000601,11736088141.947900,31153611950.319498,2962793,375260,2071477,5409530
2022-03-07,NASDAQ PSX (X),45648747,59066996,37018376,141734119,1399275459.440100,3228012916.256499,1922862255.331600,6550150631.028199,385695,311938,395350,1092983
2022-03-07,BYX Equities (Y),98899444,77782117,66759664,243441225,2827603884.421700,4371322717.303102,2764013172.537799,9962939774.262601,1009254,427330,750503,2187087
2022-03-07,BZX Equities (Z),429371649,282216820,315199414,1026787883,17662896515.363994,22087043053.320300,18571763537.661404,58321703106.345698,4962578,2013235,3930467,10906280
2022-03-04,NYSE American (A),23904108,41558230,15119322,80581660,1089437077.621100,1410498421.894900,914388846.985300,3414324346.501300,252518,183357,168435,604310
2022-03-04,NASDAQ BX (B),30810571,25968564,24654840,81433975,1509358197.961100,1920340742.924900,1792698645.824399,5222397586.710399,498087,196285,415595,1109967
2022-03-04,NYSE National (C),58667503,51806202,33081780,143555485,1593081215.478500,2095845499.147600,1168984844.751600,4857911559.377700,607957,289845,381734,1279536
2022-03-04,FINRA / Nasdaq TRF Chicago (DB),11885520,5380267,15106153,32371940,450792297.605800,183974813.693300,918204976.272100,1552972087.571200,56622,21108,70998,148728
2022-03-04,FINRA / NYSE TRF (DN),278215999,199959800,492786061,970961860,10615149024.046597,6144029632.215403,17143954164.640602,33903132820.902602,1554147,489389,1607041,3650577
2022-03-04,FINRA / Nasdaq TRF Carteret (DQ),1803777673,998698000,1934663810,4737139483,82034370813.194186,48585712051.136870,85370726199.491307,215990809063.822363,8929222,3002802,7497368,19429392
2022-03-04,MIAX Pearl (H),48004018,53231573,35586994,136822585,1551826687.657300,2593398150.373500,2169113870.761800,6314338708.792600,460156,296715,365367,1122238
2022-03-04,EDGA Equities (J),83931495,77668272,65518641,227118408,3288643108.344600,4134065182.472899,3186625034.963099,10609333325.780598,1082757,537329,818607,2438693
2022-03-04,EDGX Equities (K),323446986,173896701,320070094,817413781,12219243779.020701,9452106274.490099,14463358883.967205,36134708937.478005,2869349,1006378,2494650,6370377
2022-03-04,LTSE (L),3251,32237,62437,97925,511237.660000,982283.780000,561333.860000,2054855.300000,14,88,49,151
2022-03-04,NYSE Chicago (M),10283763,10248476,9042965,29575204,764134569.813000,2356295279.981100,1777414341.611599,4897844191.405699,62651,5436,48413,116500
2022-03-04,NYSE (N),1177674489,94015851,93222109,1364912449,59983048669.403790,5843627358.267999,4280086868.483900,70106762896.155689,5501288,353641,706155,6561084
2022-03-04,NYSE Arca (P),306649730,517374574,448857127,1272881431,13289458811.981207,34045638675.689899,23661444091.035997,70996541578.707103,3215230,2516824,4049285,9781339
2022-03-04,NASDAQ (Q),692720677,389103182,1162801484,2244625343,33821259337.738310,30122165443.054192,74343986228.368169,138287411009.160671,8600370,2850168,10443855,21894393
2022-03-04,Members Exchange (U),251802441,170812106,184002298,606616845,7280905249.369199,9450821036.050499,7224754978.113204,23956481263.532902,1947960,846021,1550202,4344183
2022-03-04,Investors Exchange (V),213149283,48461888,137618183,399229354,12788972274.035601,3100812906.218700,10043540635.147502,25933325815.401803,2426210,315941,1763314,4505465
2022-03-04,NASDAQ PSX (X),38077270,58391924,33665131,130134325,1253046663.831400,3385953085.914000,2007142413.196000,6646142162.941400,349128,308303,382164,1039595
2022-03-04,BYX Equities (Y),88853966,65532280,56572397,210958643,2440619948.795800,4073198430.911398,2397697517.826200,8911515897.533398,860012,343745,629172,1832929
2022-03-04,BZX Equities (Z),355527282,237178818,281471095,874177195,14815980630.072303,18758451929.002101,16755016782.077903,50329449341.152307,4141264,1628764,3313743,9083771
2022-03-03,NYSE American (A),20411563,33118551,12920919,66451033,892773786.995500,1213734614.648200,768722519.187800,2875230920.831500,231743,149034,153911,534688
2022-03-03,NASDAQ BX (B),25717365,20819939,23331072,69868376,1280495024.334100,1849280873.106600,1669427082.416000,4799202979.856700,479125,177524,424654,1081303
2022-03-03,NYSE National (C),49905649,39859309,30857034,120621992,1425174383.289500,1738651125.051400,1125541650.911400,4289367159.252300,603965,245151,389836,1238952
2022-03-03,FINRA / Nasdaq TRF Chicago (DB),10235962,4613427,15746177,30595566,434060603.798100,174216910.438800,827542174.638700,1435819688.875600,53576,16195,64729,134500
2022-03-03,FINRA / NYSE TRF (DN),235973555,160840050,502133824,898947429,9686124986.743902,6154029232.735002,17008403376.849705,32848557596.328609,1306926,374424,1486266,3167616
2022-03-03,FINRA / Nasdaq TRF Carteret (DQ),1524638521,820295912,1807632761,4152567194,71939111895.521076,42716312823.606727,80051196285.705642,194706621004.833445,7614721,2366738,6888243,16869702
2022-03-03,MIAX Pearl (H),42041191,48108617,31207054,121356862,1378682407.933900,2492024877.384200,1962773570.516999,5833480855.835099,402060,266739,332832,1001631
2022-03-03,EDGA Equities (J),71349438,78840863,59080405,209270706,2911301009.838500,4081677628.712499,3050899842.291900,10043878480.842899,991632,561329,767866,2320827
2022-03-03,EDGX Equities (K),288662505,138568965,308374777,735606247,11359560577.551504,8237515363.947007,13946281215.468801,33543357156.967312,2709390,833230,2356609,5899229
2022-03-03,LTSE (L),122288,2,7780,130070,1194497.860000,76.340000,227305.960000,1421880.160000,27,2,43,72
2022-03-03,NYSE Chicago (M),13150253,9504369,8552333,31206955,874409901.699600,1079555339.816100,1163018176.989500,3116983418.505200,54795,4926,43607,103328
2022-03-03,NYSE (N),1092225883,77922318,75735318,1245883519,57490460191.235292,5440350925.229800,3821687777.387501,66752498893.852593,5078709,303899,624553,6007161
2022-03-03,NYSE Arca (P),258967557,473304059,419818990,1152090606,11328079479.814400,33504708531.733097,22133593270.970311,66966381282.517808,2782134,2305506,3776641,8864281
2022-03-03,NASDAQ (Q),584969082,342864417,1147467514,2075301013,29414150487.071917,27438116202.729696,70863026933.988023,127715293623.789636,7599524,2701305,9842547,20143376
2022-03-03,Members Exchange (U),220598008,152182550,171548287,544328845,6196702479.133601,9461439403.152698,6629762101.211101,22287903983.497400,1701974,781433,1424753,3908160
2022-03-03,Investors Exchange (V),179774650,37993017,127319829,345087496,11068840635.421200,2561498190.720400,9140538569.808498,22770877395.950098,2192860,238143,1643939,4074942
2022-03-03,NASDAQ PSX (X),32683333,47260007,32394525,112337865,1105508210.957900,2545071022.766600,1821068667.456900,5471647901.181400,312614,264948,351423,928985
2022-03-03,BYX Equities (Y),75528024,52131121,51504117,179163262,2159070284.330000,3639151605.809501,2224893771.507600,8023115661.647101,792119,293612,585358,1671089
2022-03-03,BZX Equities (Z),312944327,215579303,266956722,795480352,13353329213.010496,18295472977.961603,15361554846.499505,47010357037.471604,3922383,1535131,3160364,8617878
2022-03-02,NYSE American (A),23406643,32496723,17038111,72941477,1053434342.710700,1295314195.809700,862054326.394100,3210802864.914500,246048,136838,158638,541524
2022-03-02,NASDAQ BX (B),28356233,22172144,24280454,74808831,1397605627.426700,1702939982.270300,1751097155.258800,4851642764.955800,504882,187917,422521,1115320
2022-03-02,NYSE National (C),54141096,43853606,36001907,133996609,1497518168.621300,1923120410.800300,1191878521.577200,4612517100.998800,574654,258840,381024,1214518
2022-03-02,FINRA / Nasdaq TRF Chicago (DB),8996266,3763378,14416171,27175815,369154716.373000,156484955.278600,855703772.425900,1381343444.077500,47767,14419,63406,125592
2022-03-02,FINRA / NYSE TRF (DN),258000961,153727388,487582274,899310623,9867853118.492100,5797026633.577300,17528457674.385708,33193337426.455108,1377311,368369,1506436,3252116
2022-03-02,FINRA / Nasdaq TRF Carteret (DQ),1604598992,812387454,1884895617,4301882063,75100905053.916782,44648699703.259679,82700785766.705240,202450390523.881701,8220351,2573122,7172888,17966361
2022-03-02,MIAX Pearl (H),49698155,47750633,38635716,136084504,1536436780.292100,2628925782.279100,2040595242.067500,6205957804.638700,425860,269468,345729,1041057
2022-03-02,EDGA Equities (J),76310725,82427856,63189956,221928537,3160069728.516800,4469391248.635000,3342405254.826800,10971866231.978600,1055402,608269,819283,2482954
2022-03-02,EDGX Equities (K),293789645,144228674,325622777,763641096,11368933990.808195,9153783346.021403,14836209573.664103,35358926910.493701,2597696,885294,2452442,5935432
2022-03-02,LTSE (L),6664,0,46068,52732,986856.220000,0.000000,335903.700000,1322759.920000,16,0,357,373
2022-03-02,NYSE Chicago (M),12823596,12794449,9575650,35193695,881174894.431300,1604017710.123300,1485259225.987400,3970451830.542000,54720,4816,44011,103547
2022-03-02,NYSE (N),1131062175,68404578,76772597,1276239350,60513917947.838602,4623033708.349901,3903431327.297400,69040382983.485903,5323849,298712,644903,6267464
2022-03-02,NYSE Arca (P),276261575,468588049,436060203,1180909827,12654506152.132205,35525795961.030191,22893516976.209578,71073819089.371974,2991642,2399175,3918840,9309657
2022-03-02,NASDAQ (Q),650708704,361875894,1155228920,2167813518,33767765786.241507,30281050034.493507,74605469608.583086,138654285429.318100,8697810,2891181,10344551,21933542
2022-03-02,Members Exchange (U),237209154,164079382,182547886,583836422,7057188509.416199,10057432899.782498,7431377611.821901,24545999021.020598,1887193,873117,1491925,4252235
2022-03-02,Investors Exchange (V),197049711,41526078,137852045,376427834,12413137118.416703,2859999172.189200,9852175787.234696,25125312077.840599,2545907,285566,1828197,4659670
2022-03-02,NASDAQ PSX (X),33272514,46620054,31827211,111719779,1102457410.963800,2538726380.556400,1860459877.804300,5501643669.324500,323665,273116,366171,962952
2022-03-02,BYX Equities (Y),81497718,54240026,55988723,191726467,2341092787.350100,3798285864.709699,2337470849.727100,8476849501.786899,824409,317056,616287,1757752
2022-03-02,BZX Equities (Z),320688542,231755261,268828832,821272635,14053228103.188201,21003393421.670108,15826077026.242399,50882698551.100708,3944514,1701851,3281909,8928274
2022-03-01,NYSE American (A),24470480,40819669,18598387,83888536,1168227095.694000,1536333675.973700,1003290742.863800,3707851514.531500,270576,176249,181200,628025
2022-03-01,NASDAQ BX (B),35506909,44829710,35957639,116294258,1563396169.453200,2928545669.074400,2094534594.591200,6586476433.118800,573797,338387,525078,1437262
2022-03-01,NYSE National (C),62516224,58201407,40604249,161321880,1654905524.861100,2584536551.253000,1407269595.326100,5646711671.440200,633075,328471,423240,1384786
2022-03-01,FINRA / Nasdaq TRF Chicago (DB),9929329,4358251,15589064,29876644,463750501.654400,161640831.040200,969093474.958200,1594484807.652800,54222,19143,77316,150681
2022-03-01,FINRA / NYSE TRF (DN),275958326,180555458,583442270,1039956054,10905313052.633600,5975964974.100998,19365290914.775110,36246568941.509708,1490745,423656,1731632,3646033
2022-03-01,FINRA / Nasdaq TRF Carteret (DQ),1684884992,989675821,2118625191,4793186004,83162109428.554117,56869705270.715896,87296830691.265176,227328645390.535189,8838394,2686335,7900328,19425057
2022-03-01,MIAX Pearl (H),46669838,56643036,43474304,146787178,1633953492.988300,3004082876.534500,2113690753.656600,6751727123.179400,459189,315252,392399,1166840
2022-03-01,EDGA Equities (J),81842167,100378072,73889198,256109437,3536902869.535800,5286457434.356899,3872813807.539399,12696174111.432098,1137420,731565,926112,2795097
2022-03-01,EDGX Equities (K),320571233,174508926,392482738,887562897,12821827604.972999,10582079146.948399,16309820781.921200,39713727533.842598,2992017,1064013,2868464,6924494
2022-03-01,LTSE (L),5673,149,550285,556107,767941.730000,5696.270000,24292640.340000,25066278.340000,23,1,449,473
2022-03-01,NYSE Chicago (M),10476945,7002522,10261530,27740997,825533562.056300,1071703087.668500,1435201316.817600,3332437966.542400,81934,5605,59141,146680
2022-03-01,NYSE (N),1328623793,97767872,100543317,1526934982,73085571392.976007,6361750846.977002,4544641488.417599,83991963728.370608,6124805,399934,771669,7296408
2022-03-01,NYSE Arca (P),298954056,552584459,524065143,1375603658,13356014655.037102,40076776683.776185,23998387684.642906,77431179023.456193,3204490,2876516,4383329,10464335
2022-03-01,NASDAQ (Q),707399028,443188657,1376486655,2527074340,35955204552.643602,35921276661.763872,82555592703.033519,154432073917.440993,9275479,3478823,11551750,24306052
2022-03-01,Members Exchange (U),253468930,190650731,221936288,666055949,7630900801.101700,11715792336.218900,7536309294.501999,26883002431.822599,2069431,1027712,1665073,4762216
2022-03-01,Investors Exchange (V),213727527,49199631,150318130,413245288,13244996625.248898,3429568607.339900,10200769710.002700,26875334942.591498,2553154,295971,1898425,4747550
2022-03-01,NASDAQ PSX (X),38257440,62445097,39548560,140251097,1260973515.040400,3441841632.687700,1983929227.799900,6686744375.528000,337883,316755,391289,1045927
2022-03-01,BYX Equities (Y),93943401,77240086,78178452,249361939,2661547695.611900,4776515494.276900,2784264424.207799,10222327614.096599,946374,442932,758484,2147790
2022-03-01,BZX Equities (Z),359033048,267471510,306799022,933303580,15556524894.715301,22536928655.983806,17990892003.776903,56084345554.476010,4482955,1961928,3846664,10291547
2022-02-28,NYSE American (A),23318841,43020885,15842964,82182690,1110979134.391200,1376229023.513900,896661349.121500,3383869507.026600,254986,159401,167945,582332
2022-02-28,NASDAQ BX (B),33857090,40443552,31189711,105490353,1543752291.207300,2524656444.832200,1948131207.297700,6016539943.337200,543483,297772,478836,1320091
2022-02-28,NYSE National (C),59498053,52469727,37456309,149424089,1605522184.129500,2270907563.488900,1217369234.106300,5093798981.724700,605761,277025,389715,1272501
2022-02-28,FINRA / Nasdaq TRF Chicago (DB),9976694,4154894,14728508,28860096,425182203.497600,144897739.095400,1048468536.238000,1618548478.831000,53357,17213,77657,148227
2022-02-28,FINRA / NYSE TRF (DN),254296699,174543900,500549053,929389652,10229348558.982200,5731553581.855701,19769059835.579008,35729961976.416909,1445443,388750,1702754,3536947
2022-02-28,FINRA / Nasdaq TRF Carteret (DQ),1785223699,922747883,2067819962,4775791544,88928348283.445283,55716637734.485980,100193998492.677480,244838984510.608743,8390300,2684512,7610238,18685050
2022-02-28,MIAX Pearl (H),43802760,52790097,34560415,131153272,1547184804.528600,2863791778.920199,2387728953.396400,6798705536.845199,442906,291903,373808,1108617
2022-02-28,EDGA Equities (J),76704633,84078601,61242236,222025470,3258345232.804300,4537480482.225001,3504552744.039501,11300378459.068802,1060920,588623,825530,2475073
2022-02-28,EDGX Equities (K),301005684,156412395,341116138,798534217,11946530216.981702,10326255460.147506,16404121787.730294,38676907464.859502,2713440,948320,2588499,6250259
2022-02-28,LTSE (L),1867,97774,61191,160832,730932.080000,14391331.270000,4699385.410000,19821648.760000,23,815,154,992
2022-02-28,NYSE Chicago (M),9024258,6449272,11353466,26826996,845899926.908300,1037671072.791800,1686711822.577600,3570282822.277700,68077,4466,56241,128784
2022-02-28,NYSE (N),1652218282,86220122,85152445,1823590849,90513313677.083293,5963410269.824002,3915929335.366501,100392653282.273796,5642427,348136,660663,6651226
2022-02-28,NYSE Arca (P),275360131,535715520,452695690,1263771341,12322458894.613994,41846438313.936596,25182882391.069403,79351779599.619993,2981599,2647684,4079622,9708905
2022-02-28,NASDAQ (Q),657343123,404901481,1521618424,2583863028,33279643516.350899,34131927780.314290,96755196340.076716,164166767636.741905,8535071,3052292,10804942,22392305
2022-02-28,Members Exchange (U),238028182,184684011,219979968,642692161,6990518826.229899,11099368922.584700,7911188763.620204,26001076512.434803,1916192,915410,1618608,4450210
2022-02-28,Investors Exchange (V),201284237,47176541,144553427,393014205,12435820476.594198,3279946362.875400,9962363094.444699,25678129933.914297,2506829,281711,1895952,4684492
2022-02-28,NASDAQ PSX (X),34320143,56780124,38167023,129267290,1235887992.630400,3468624243.374000,1911209568.255200,6615721804.259600,312731,285000,372617,970348
2022-02-28,BYX Equities (Y),89089650,71097031,71111368,231298049,2558706048.893400,4403191503.647801,2669373062.992400,9631270615.533601,910288,391855,710662,2012805
2022-02-28,BZX Equities (Z),327016078,249876482,278933091,855825651,14036021041.640898,22394810014.092888,17192870543.159999,53623701598.893785,4038264,1761959,3474949,9275172
2022-02-25,NYSE American (A),21456950,32857922,15074821,69389693,1038767665.134900,1250270550.725400,774197967.647900,3063236183.508200,239430,137330,158805,535565
2022-02-25,NASDAQ BX (B),27654578,23513704,25602632,76770914,1424826628.653000,1986553195.717500,1723511298.373200,5134891122.743700,497876,185226,437104,1120206
2022-02-25,NYSE National (C),53356515,45681436,31306723,130344674,1489742065.938900,2025624801.700700,1115766194.082500,4631133061.722100,602129,261698,382958,1246785
2022-02-25,FINRA / Nasdaq TRF Chicago (DB),9061363,3633322,13854372,26549057,347410135.987100,140071906.516500,1065257324.444900,1552739366.948500,48388,14958,73027,136373
2022-02-25,FINRA / NYSE TRF (DN),243980013,158991105,377877744,780848862,9308190295.756899,5566058882.249503,18724418851.483099,33598668029.489501,1332023,354397,1473590,3160010
2022-02-25,FINRA / Nasdaq TRF Carteret (DQ),1521980580,826509508,1613268025,3961758113,71328532088.100005,46993902089.992852,88298047786.924368,206620481965.017225,8055879,2428455,7346806,17831140
2022-02-25,MIAX Pearl (H),43291107,48038649,33492749,124822505,1511993983.250500,2702530132.191500,2141138324.641100,6355662440.083100,431571,261249,337243,1030063
2022-02-25,EDGA Equities (J),76224907,81790657,58960964,216976528,3236350070.335200,4345518978.151900,3432964600.186300,11014833648.673400,1064519,578321,829443,2472283
2022-02-25,EDGX Equities (K),292703362,143705529,269447859,705856750,11185298012.433103,9241062241.021999,15607211684.712997,36033571938.168099,2535918,847308,2362225,5745451
2022-02-25,LTSE (L),961,800,44039,45800,349996.210000,17413.000000,1493222.240000,1860631.450000,32,2,60,94
2022-02-25,NYSE Chicago (M),11975657,11494762,15874587,39345006,892199674.925200,1528094762.265000,2662062428.067900,5082356865.258100,56836,3886,47184,107906
2022-02-25,NYSE (N),1115361349,69313034,79242199,1263916582,60120745881.257401,4789872538.875401,3894877877.834199,68805496297.967001,5209276,288242,656998,6154516
2022-02-25,NYSE Arca (P),265200630,475229001,355641627,1096071258,11869484010.778501,34507836644.624017,24611689338.349618,70989009993.752136,2833800,2300381,3790959,8925140
2022-02-25,NASDAQ (Q),639566201,366081323,1093401701,2099049225,32748614086.953384,31229593181.360481,76436207299.058303,140414414567.372168,8173944,2812324,10362200,21348468
2022-02-25,Members Exchange (U),240996150,176574165,181498347,599068662,7083130681.954501,11408569609.469301,8158761240.619398,26650461532.043200,1922686,904689,1541746,4369121
2022-02-25,Investors Exchange (V),180656285,39986476,132439841,353082602,11374760649.541202,2912764452.643100,9939860573.606100,24227385675.790402,2208819,245251,1725606,4179676
2022-02-25,NASDAQ PSX (X),35594410,50442119,30705401,116741930,1177800750.857000,2855357818.439800,1811092250.723500,5844250820.020300,327951,268974,354541,951466
2022-02-25,BYX Equities (Y),79597842,57353210,53902646,190853698,2268277969.633700,4267249674.506199,2382110306.874100,8917637951.013999,832819,316289,620483,1769591
2022-02-25,BZX Equities (Z),318401612,221824701,247085858,787312171,13849841790.675696,19539570324.555203,17450947715.342300,50840359830.573199,3867357,1601503,3246290,8715150
2022-02-24,NYSE American (A),25603210,56574762,17663876,99841848,1123714915.983400,1762690106.089900,1200874249.175900,4087279271.249200,266982,211582,189681,668245
2022-02-24,NASDAQ BX (B),34575076,38467281,34723542,107765899,1708473753.539500,2911592243.182799,2654916626.911200,7274982623.633499,596571,298235,584907,1479713
2022-02-24,NYSE National (C),62677182,64698337,38237311,165612830,1639670886.068400,2667115859.514001,1483956495.338499,5790743240.920900,647036,371870,440656,1459562
2022-02-24,FINRA / Nasdaq TRF Chicago (DB),12477474,6708718,17246704,36432896,459224250.433200,196506114.309800,1326516115.965800,1982246480.708800,58650,22729,92938,174317
2022-02-24,FINRA / NYSE TRF (DN),302003445,255729961,434914026,992647432,10276486319.809398,8264639192.913900,23975632565.615396,42516758078.338694,1666289,579298,1898736,4144323
2022-02-24,FINRA / Nasdaq TRF Carteret (DQ),1969924575,1420925731,2122097893,5512948199,85741463534.761091,81790443489.287436,122837539304.616560,290369446328.665087,10397533,4281126,9911041,24589700
2022-02-24,MIAX Pearl (H),49334437,74763029,41887812,165985278,1536222446.262500,3849326616.046400,2640447127.826899,8025996190.135799,457445,388820,400391,1246656
2022-02-24,EDGA Equities (J),98596533,138212485,77975416,314784434,3894329057.053000,6902036022.465701,4829243234.810603,15625608314.329304,1306371,972407,1084088,3362866
2022-02-24,EDGX Equities (K),381570856,252452077,351114992,985137925,13386532699.776802,14515214669.593602,21369696093.671803,49271443463.042207,3274923,1535004,3140737,7950664
2022-02-24,LTSE (L),1045,81155,3812,86012,981095.950000,9401204.280000,661644.430000,11043944.660000,56,16,37,109
2022-02-24,NYSE Chicago (M),15966793,11647438,13533975,41148206,1341114553.213200,1890073448.257001,2188380069.729101,5419568071.199302,101103,5680,75635,182418
2022-02-24,NYSE (N),1467703363,114314192,104200792,1686218347,73869730870.231712,7430877599.714399,5542988769.363199,86843597239.309310,6833527,509613,873103,8216243
2022-02-24,NYSE Arca (P),356656854,796918447,497709091,1651284392,14606301090.385801,55365776956.868925,36904364274.310104,106876442321.564830,3617322,4025323,5280138,12922783
2022-02-24,NASDAQ (Q),874991040,643394200,1575713591,3094098831,40909328273.348914,52878897326.082883,115954641030.344812,209742866629.776609,10468776,4821131,14173131,29463038
2022-02-24,Members Exchange (U),310954855,289715875,227023719,827694449,8407108215.223500,16810409314.585305,10461395207.082605,35678912736.891410,2335337,1381931,1955369,5672637
2022-02-24,Investors Exchange (V),237102949,64030840,184891559,486025348,14543175807.785502,4228358064.576500,14829863717.759401,33601397590.121403,2742545,375320,2231863,5349728
2022-02-24,NASDAQ PSX (X),46383992,80536577,43735548,170656117,1523442709.838700,4558790166.128901,2767015198.621200,8849248074.588801,401348,462847,459572,1323767
2022-02-24,BYX Equities (Y),98701601,89517428,65135542,253354571,2622863829.825500,5647227960.577497,3334447749.201901,11604539539.604898,969542,482624,768045,2220211
2022-02-24,BZX Equities (Z),406910567,380375444,332397082,1119683093,16320184419.852802,34133123014.447762,24014364866.327996,74467672300.628560,4844323,2771548,4361143,11977014
2022-02-23,NYSE American (A),20178308,34184671,14591104,68954083,849235048.045100,1148922769.983700,856744869.923300,2854902687.952100,221681,135913,154746,512340
2022-02-23,NASDAQ BX (B),24928803,20306314,24139316,69374433,1166960529.159000,1648529030.693000,1818126594.687600,4633616154.539600,456310,155227,442648,1054185
2022-02-23,NYSE National (C),44375868,42914744,30348714,117639326,1217216294.115900,1791314322.126200,1095528364.547300,4104058980.789400,493935,230880,342221,1067036
2022-02-23,FINRA / Nasdaq TRF Chicago (DB),8413349,3834350,12405023,24652722,313142011.202000,164027429.812100,1053561032.660200,1530730473.674300,41434,13711,72962,128107
2022-02-23,FINRA / NYSE TRF (DN),228203053,164753824,386728240,779685117,7770208258.139401,6033095244.800795,19400416538.551000,33203720041.491196,1267501,382451,1572054,3222006
2022-02-23,FINRA / Nasdaq TRF Carteret (DQ),1515457110,878657898,1664719373,4058834381,67842622668.007300,53253319668.950501,96623143490.953569,217719085827.911370,7771911,2541960,7804936,18118807
2022-02-23,MIAX Pearl (H),36943015,43795626,29150559,109889200,1172457351.240300,2550138762.911900,1988095118.943900,5710691233.096100,372214,246335,340501,959050
2022-02-23,EDGA Equities (J),69454378,76695199,59608379,205757956,2814286237.515900,4045993783.206999,3495004146.895900,10355284167.618799,980359,538431,831569,2350359
2022-02-23,EDGX Equities (K),260191570,136866409,267871027,664929006,9422669286.283201,8515861969.655103,14953409855.835798,32891941111.774102,2386944,847454,2399108,5633506
2022-02-23,LTSE (L),4340,7,93292,97639,1869821.130000,579.530000,339398.791500,2209799.451500,61,1,61,123
2022-02-23,NYSE Chicago (M),11329055,10336149,11393309,33058513,829746634.447800,1703788198.392800,2073380241.811100,4606915074.651700,54460,2828,43267,100555
2022-02-23,NYSE (N),1012567839,72877533,80778923,1166224295,51274325206.358102,5187679261.496199,4166831032.072199,60628835499.926500,4850322,286253,648165,5784740
2022-02-23,NYSE Arca (P),241050284,408307427,367721983,1017079694,10209014632.036299,32573419447.822610,24178872348.082512,66961306427.941421,2609081,2156529,3838157,8603767
2022-02-23,NASDAQ (Q),570839396,336220189,1065121770,1972181355,27937349470.963090,29035473333.334897,77323482109.965504,134296304914.263491,7538847,2592566,10291749,20423162
2022-02-23,Members Exchange (U),212289607,160376497,183485131,556151235,5839581684.846400,10323011547.647801,7766562140.714099,23929155373.208300,1695542,813159,1496805,4005506
2022-02-23,Investors Exchange (V),163765839,34193396,123976622,321935857,9814867825.137700,2704309091.505100,9809797870.124799,22328974786.767599,1992618,218954,1584217,3795789
2022-02-23,NASDAQ PSX (X),29378636,47291100,32348248,109017984,970562643.147700,2641815446.874000,2061355433.177600,5673733523.199300,285581,236913,385031,907525
2022-02-23,BYX Equities (Y),69952585,52810058,52664392,175427035,1944367531.180000,3848873776.237100,2354858452.195400,8148099759.612500,765526,291579,623792,1680897
2022-02-23,BZX Equities (Z),278113052,205377722,232192758,715683532,11479313531.237204,17262076764.136189,15714213847.735190,44455604143.108583,3460790,1501170,3127922,8089882
2022-02-22,NYSE American (A),20131274,32228216,14183228,66542718,877454209.281200,1114942806.998000,806270606.999200,2798667623.278400,218322,145648,163555,527525
2022-02-22,NASDAQ BX (B),25723446,21345273,24651467,71720186,1155053656.796900,1929270378.507199,1909520773.272400,4993844808.576499,464054,183413,462680,1110147
2022-02-22,NYSE National (C),50206234,44733883,33006341,127946458,1275445797.441900,1895144095.454800,1166831471.515400,4337421364.412100,503561,234001,366672,1104234
2022-02-22,FINRA / Nasdaq TRF Chicago (DB),9922337,4330837,13713645,27966819,369881785.328500,155923595.063200,1071072309.860700,1596877690.252400,49672,17191,75950,142813
2022-02-22,FINRA / NYSE TRF (DN),244529145,158130421,392750944,795410510,9142346114.819699,5784383543.801799,20499194184.126905,35425923842.748403,1433580,431685,1723675,3588940
2022-02-22,FINRA / Nasdaq TRF Carteret (DQ),1602295435,821528547,1702181024,4126005006,77204038660.824302,48274153983.136902,103227403461.248990,228705596105.210194,7962957,2767957,7882747,18613661
2022-02-22,MIAX Pearl (H),41377045,45130174,28743952,115251171,1242801403.437000,2407876590.015601,1765731830.027900,5416409823.480501,397592,256836,340954,995382
2022-02-22,EDGA Equities (J),74429681,85336757,61241670,221008108,2959369887.472700,4375203307.588898,3607401304.636600,10941974499.698198,1023737,615895,870294,2509926
2022-02-22,EDGX Equities (K),284856690,142813600,289524854,717195144,10446890207.715801,8959261511.920604,16499694547.008592,35905846266.644997,2550316,922952,2565859,6039127
2022-02-22,LTSE (L),2054,1000,193012,196066,1487891.220000,22020.000000,609502.520000,2119413.740000,23,4,105,132
2022-02-22,NYSE Chicago (M),21040842,8360787,12155103,41556732,1454525136.118900,851968085.956000,2305342614.811700,4611835836.886600,74238,3703,59071,137012
2022-02-22,NYSE (N),1097348927,85321652,85447149,1268117728,56434780350.778196,5670342694.072101,4284975125.592400,66390098170.442697,5088878,337065,667029,6092972
2022-02-22,NYSE Arca (P),254881134,462521928,395341769,1112744831,10868734469.762699,35407965407.563790,26654701635.249504,72931401512.575993,2726807,2467572,4059089,9253468
2022-02-22,NASDAQ (Q),600645305,362507358,1141385146,2104537809,29067810696.154302,30948194616.453617,80949867383.655667,140965872696.263586,7810357,2973521,10933454,21717332
2022-02-22,Members Exchange (U),228464421,164275536,187448208,580188165,5979001815.949198,10162561927.131301,7810338193.207699,23951901936.288198,1746814,867407,1573160,4187381
2022-02-22,Investors Exchange (V),163594325,40414653,127275321,331284299,10224741192.808300,3120324488.161400,10217011401.728700,23562077082.698400,2011948,266192,1640322,3918462
2022-02-22,NASDAQ PSX (X),32836091,52203212,36794640,121833943,1078030979.620200,2931986511.494701,2278976975.017601,6288994466.132502,315580,273193,418368,1007141
2022-02-22,BYX Equities (Y),75788968,54097499,52134679,182021146,2038642171.868500,3676396130.726300,2533844428.033598,8248882730.628398,798396,318106,657899,1774401
2022-02-22,BZX Equities (Z),293829521,220563288,251002730,765395539,12086453673.426102,18441360971.851599,16936607207.994704,47464421853.272405,3564102,1628221,3300462,8492785
2022-02-18,NYSE American (A),16719445,27078531,14179835,57977811,721439594.932400,989611011.455200,794484106.700100,2505534713.087700,199020,118881,152019,469920
2022-02-18,NASDAQ BX (B),23715329,18748775,23137220,65601324,1142597855.304900,1499799735.412000,1987251205.818400,4629648796.535300,444135,153114,435243,1032492
2022-02-18,NYSE National (C),44083505,36207997,29138473,109429975,1237032374.933200,1613457932.589400,1076684719.191000,3927175026.713600,472181,186047,349660,1007888
2022-02-18,FINRA / Nasdaq TRF Chicago (DB),9052825,3491306,12928261,25472392,318680509.108300,118996175.725100,1048129921.485900,1485806606.319300,43830,12688,74172,130690
2022-02-18,FINRA / NYSE TRF (DN),239406144,140905572,369996558,750308274,8178341349.951599,5262551672.429100,20323636275.196792,33764529297.577491,1241663,325925,1516977,3084565
2022-02-18,FINRA / Nasdaq TRF Carteret (DQ),1422896519,693373637,1540414537,3656684693,61853616578.475876,48736961004.381513,91944365817.773027,202534943400.630416,7350089,2155721,7562538,17068348
2022-02-18,MIAX Pearl (H),35970297,40112462,29313050,105395809,1105122519.951600,2295279389.493700,1712725718.380600,5113127627.825900,349320,231872,300970,882162
2022-02-18,EDGA Equities (J),68464863,68859058,57258704,194582625,2740860687.141100,3757006834.051600,3396885087.202401,9894752608.395101,971890,505500,857595,2334985
2022-02-18,EDGX Equities (K),254562276,117881478,253596606,626040360,9067499948.764196,8084886332.050698,15200340776.821500,32352727057.636394,2316914,776154,2384732,5477800
2022-02-18,LTSE (L),853,8556,71262,80671,727372.520000,2717796.260000,108847.570000,3554016.350000,23,76,9,108
2022-02-18,NYSE Chicago (M),22152069,8077010,18742595,48971674,1704673226.557000,1345542114.452500,4136000451.070402,7186215792.079902,46974,2433,41316,90723
2022-02-18,NYSE (N),1099832577,66861658,77356090,1244050325,60890130474.882506,4958748442.612899,4172187698.365299,70021066615.860704,4587096,268579,635381,5491056
2022-02-18,NYSE Arca (P),226784532,384723365,350273667,961781564,9505940257.510597,30009659799.925773,23692002903.907609,63207602961.343979,2520397,2053634,3772648,8346679
2022-02-18,NASDAQ (Q),540037154,312137773,1131108982,1983283909,27245774447.270406,28008563660.376508,81269177208.942220,136523515316.589134,7104816,2534318,10120983,19760117
2022-02-18,Members Exchange (U),193879584,144281372,159446067,497607023,5366463911.280699,10037244551.824999,6823346442.245999,22227054905.351697,1597024,756726,1416160,3769910
2022-02-18,Investors Exchange (V),155149056,32785345,121188954,309123355,9250506730.019002,2520722095.193900,9851403518.958299,21622632344.171201,1951478,214466,1629625,3795569
2022-02-18,NASDAQ PSX (X),28833384,49147182,32473242,110453808,952697683.089200,3508736806.287301,2190936010.565600,6652370499.942101,286130,247249,371549,904928
2022-02-18,BYX Equities (Y),67184844,48242158,49682819,165109821,1868417957.194000,3421881375.133000,2409591423.769900,7699890756.096900,737847,282537,626329,1646713
2022-02-18,BZX Equities (Z),259339833,192201172,231636489,683177494,11140024665.757403,16902955131.756811,15896788441.569302,43939768239.083516,3197902,1421438,3031879,7651219
2022-02-17,NYSE American (A),16987975,26825372,11574400,55387747,853838190.562100,1212886694.674700,812589207.565000,2879314092.801800,229647,117306,156857,503810
2022-02-17,NASDAQ BX (B),23497418,17948566,21323838,62769822,1216429776.093200,1730307095.809100,1897190249.966800,4843927121.869100,443090,138987,405902,987979
2022-02-17,NYSE National (C),45534238,36672996,27167904,109375138,1305890586.534500,1525139543.728400,1083244975.613900,3914275105.876800,484461,189560,321556,995577
2022-02-17,FINRA / Nasdaq TRF Chicago (DB),8531653,3890996,11989917,24412566,359921618.325000,167726825.079800,930202790.289600,1457851233.694400,43342,11520,70096,124958
2022-02-17,FINRA / NYSE TRF (DN),246661688,160749216,365490919,772901823,9158303546.861101,4914150531.455900,18265214988.661113,32337669066.978114,1305864,320036,1546489,3172389
2022-02-17,FINRA / Nasdaq TRF Carteret (DQ),1470874090,690124357,1522362870,3683361317,68284721193.176710,38332189585.973596,89647185000.178432,196264095779.328738,7480604,2024312,7328520,16833436
2022-02-17,MIAX Pearl (H),32518788,36495792,27831307,96845887,1064752831.687700,2232380202.204600,1987858397.662100,5284991431.554400,321547,193584,273685,788816
2022-02-17,EDGA Equities (J),66568719,66147670,53055396,185771785,2828802866.011100,3556362135.149800,3206009694.876999,9591174696.037899,962613,458350,775118,2196081
2022-02-17,EDGX Equities (K),257360101,117525085,255822676,630707862,10045304580.758603,7009649186.766303,14327125683.164393,31382079450.689299,2334660,669283,2284501,5288444
2022-02-17,LTSE (L),150385,0,67590,217975,27503128.860000,0.000000,1727422.980000,29230551.840000,1273,0,60,1333
2022-02-17,NYSE Chicago (M),13036534,9188980,13589430,35814944,782845891.816400,1904583190.064400,2803794402.523200,5491223484.404000,39442,2628,30398,72468
2022-02-17,NYSE (N),923473887,62723988,70165370,1056363245,48991176645.899805,4695162015.944202,4215544856.220500,57901883518.064507,4184420,233989,594979,5013388
2022-02-17,NYSE Arca (P),221086256,366113852,321188090,908388198,10012332140.015298,27409163628.227911,22557282609.940994,59978778378.184203,2395605,1766441,3462135,7624181
2022-02-17,NASDAQ (Q),523438329,279274041,1029830684,1832543054,26390005450.819903,23851879091.766491,72150158129.497096,122392042672.083490,6747107,2081192,9200990,18029289
2022-02-17,Members Exchange (U),188059769,133394939,151436678,472891386,5357245741.753800,8943227854.892200,6352295897.093901,20652769493.739901,1553142,660389,1332643,3546174
2022-02-17,Investors Exchange (V),157624519,29966216,115514660,303105395,9917649748.190200,2238489104.602000,9602660060.349600,21758798913.141800,1992888,197463,1493968,3684319
2022-02-17,NASDAQ PSX (X),26887919,43148344,29446314,99482577,929429552.860900,3231892673.104200,1849464513.161200,6010786739.126300,268883,206447,328001,803331
2022-02-17,BYX Equities (Y),71870635,48411982,46124790,166407407,2016439201.002700,3203845000.146400,2342559366.780300,7562843567.929400,750097,256738,583191,1590026
2022-02-17,BZX Equities (Z),245258010,170765411,204389116,620412537,10661497606.119298,13523913427.337697,14285290971.274991,38470702004.731986,2945253,1140580,2651093,6736926
2022-02-16,NYSE American (A),16434438,23782459,10989044,51205941,725259378.419300,889584584.732600,656454581.478200,2271298544.630100,210597,108315,145741,464653
2022-02-16,NASDAQ BX (B),21605692,17141720,20843567,59590979,1136403014.442800,1471007086.493501,1768254526.939300,4375664627.875601,435091,131409,418523,985023
2022-02-16,NYSE National (C),38875840,34242715,27407939,100526494,1220902207.604500,1503706852.727200,1031566795.839000,3756175856.170700,442505,179082,320328,941915
2022-02-16,FINRA / Nasdaq TRF Chicago (DB),8144249,2563858,12522463,23230570,307125628.655900,91620349.512600,886394501.755700,1285140479.924200,38483,8843,66955,114281
2022-02-16,FINRA / NYSE TRF (DN),229082546,117077566,392678448,738838560,8384555393.470101,4529423903.914300,19733519324.460195,32647498621.844596,1250589,275813,1481421,3007823
2022-02-16,FINRA / Nasdaq TRF Carteret (DQ),1405516512,596270443,1538760912,3540547867,69542043507.466496,38451576995.383506,88566207335.001035,196559827837.851037,6898945,1874232,6747975,15521152
2022-02-16,MIAX Pearl (H),33003603,32306812,27572394,92882809,1100425627.709900,1975231939.645600,1674301222.750900,4749958790.106400,321161,174748,281773,777682
2022-02-16,EDGA Equities (J),62464795,64392998,52807654,179665447,2795435106.832500,3387914238.943200,3085179302.179600,9268528647.955300,926287,440919,763369,2130575
2022-02-16,EDGX Equities (K),249000669,102094547,248174629,599269845,10239784742.457400,6448354526.192704,14414764149.685697,31102903418.335801,2304274,606513,2178360,5089147
2022-02-16,LTSE (L),2805,100,41910,44815,2416637.820000,2188.000000,3111267.080000,5530092.900000,33,1,91,125
2022-02-16,NYSE Chicago (M),6480358,7045574,13309597,26835529,508137057.260300,861601860.923000,2925856413.177701,4295595331.361001,33439,3457,27242,64138
2022-02-16,NYSE (N),889881853,56455719,68654003,1014991575,48754985772.397010,4011822066.273600,3835221805.205001,56602029643.875611,4265932,211725,592183,5069840
2022-02-16,NYSE Arca (P),213013797,320892962,324679574,858586333,9844142385.969100,24231187894.352001,22565107956.571700,56640438236.892801,2383615,1570259,3405252,7359126
2022-02-16,NASDAQ (Q),487834563,245285568,940572830,1673692961,25993814803.790803,21149623551.873006,65001414434.716784,112144852790.380593,6570078,1900406,8850805,17321289
2022-02-16,Members Exchange (U),173442228,119295452,165374220,458111900,5003237974.901400,8248013314.339103,6355367349.114400,19606618638.354903,1490944,595399,1330462,3416805
2022-02-16,Investors Exchange (V),136564293,29266906,112068706,277899905,9404177013.899800,2137924512.769000,8910774300.918898,20452875827.587698,1801967,195795,1453618,3451380
2022-02-16,NASDAQ PSX (X),24073941,35361488,27215714,86651143,818663269.394300,2457089040.852200,1647146357.085200,4922898667.331700,246449,175644,325851,747944
2022-02-16,BYX Equities (Y),59479586,40186209,46883304,146549099,1857334455.536200,2946117009.743300,2127464225.291800,6930915690.571300,703711,232169,575748,1511628
2022-02-16,BZX Equities (Z),228740603,153351509,208011103,590103215,10449007613.680999,12683688409.021804,13376497340.263506,36509193362.966309,2969174,1076990,2631408,6677572
2022-02-15,NYSE American (A),18896259,25115653,15460554,59472466,888347274.670700,1054083991.558500,883012143.944400,2825443410.173600,210461,105505,152612,468578
2022-02-15,NASDAQ BX (B),22991363,16392837,21578872,60963072,1156513639.595700,1536768545.240600,1718853002.545200,4412135187.381500,399343,122680,382639,904662
2022-02-15,NYSE National (C),43169375,34654206,30193034,108016615,1323025978.223000,1544960494.012600,1178303925.814100,4046290398.049700,464298,168807,337859,970964
2022-02-15,FINRA / Nasdaq TRF Chicago (DB),8833228,2601467,11209711,22644406,319723386.878300,121321537.147000,807260983.079400,1248305907.104700,42010,9637,59697,111344
2022-02-15,FINRA / NYSE TRF (DN),233354590,121315038,377376265,732045893,8116916857.771802,4422252731.018201,18749366719.460319,31288536308.250322,1232629,281502,1430040,2944171
2022-02-15,FINRA / Nasdaq TRF Carteret (DQ),1446170458,587756614,1634162736,3668089808,69467060858.319690,35677232378.468090,91652239741.526514,196796532978.314294,7035432,1821456,6707929,15564817
2022-02-15,MIAX Pearl (H),34846472,32020158,30684258,97550888,1109296996.538000,2094432408.150499,2019548560.456400,5223277965.144899,333378,164677,288380,786435
2022-02-15,EDGA Equities (J),63389870,58175678,56331411,177896959,2650413279.098100,3185399647.143500,3041437977.072700,8877250903.314300,895019,400532,729500,2025051
2022-02-15,EDGX Equities (K),249949658,99145352,252827996,601923006,9423070123.173498,6620375882.099004,14354231364.788706,30397677370.061208,2123635,578070,2057089,4758794
2022-02-15,LTSE (L),45637,2200,11346,59183,3697376.700000,295818.000000,274689.920000,4267884.620000,55,3,41,99
2022-02-15,NYSE Chicago (M),7005983,7952349,9601919,24560251,507307482.346100,916368356.770000,1979866293.641900,3403542132.758000,35462,2516,30156,68134
2022-02-15,NYSE (N),919198978,61146610,73574176,1053919764,49312211537.508796,4498601891.803002,4047264604.540401,57858078033.852199,4163249,225318,545514,4934081
2022-02-15,NYSE Arca (P),223226953,337148907,327047449,887423309,9912939702.161597,26056658098.609493,21719177128.446983,57688774929.218073,2401985,1561657,3277619,7241261
2022-02-15,NASDAQ (Q),512044533,254010799,994072181,1760127513,25954885955.122204,22243627170.899808,69632160418.735517,117830673544.757529,6460729,1865451,8739423,17065603
2022-02-15,Members Exchange (U),181022163,117468997,174497814,472988974,5081681716.575100,7635432025.863101,6812871994.352300,19529985736.790501,1466597,580556,1295144,3342297
2022-02-15,Investors Exchange (V),144073878,27153198,120072143,291299219,9466049496.827801,1904529942.056400,9036333502.274099,20406912941.158300,1811947,188855,1509242,3510044
2022-02-15,NASDAQ PSX (X),24628741,37326319,31566427,93521487,848454377.100800,2792731185.689100,1820079912.583400,5461265475.373300,238558,178292,315941,732791
2022-02-15,BYX Equities (Y),65398329,42193705,50792589,158384623,1940603176.293800,3150508033.188202,2339426188.612800,7430537398.094802,703369,239114,570476,1512959
2022-02-15,BZX Equities (Z),232584946,148000716,205785844,586371506,10215682364.379300,12635372265.797801,13271396830.120497,36122451460.297598,2841502,986963,2505863,6334328
2022-02-14,NYSE American (A),15041431,28429561,10447126,53918118,744901267.234100,1113372589.632000,705649603.838700,2563923460.704800,176787,124889,125473,427149
2022-02-14,NASDAQ BX (B),21140873,20664853,22107917,63913643,1161237720.288500,1815233302.672700,2071570107.417000,5048041130.378200,390362,162667,388690,941719
2022-02-14,NYSE National (C),45745497,42105300,28047757,115898554,1244924585.103900,1823689782.673600,1070829288.405200,4139443656.182700,455248,227295,311213,993756
2022-02-14,FINRA / Nasdaq TRF Chicago (DB),7842464,3352585,11371186,22566235,331616494.645400,149607213.129200,926730391.683000,1407954099.457600,41877,12342,70036,124255
2022-02-14,FINRA / NYSE TRF (DN),225885490,152964757,390816490,769666737,8681758227.911105,6175916815.548010,19947251082.404511,34804926125.863626,1240374,360579,1535788,3136741
2022-02-14,FINRA / Nasdaq TRF Carteret (DQ),1408185612,704344772,1528473727,3641004111,70254984457.245088,42635776915.053498,91779523488.747120,204670284861.045706,6858144,2274497,6550118,15682759
2022-02-14,MIAX Pearl (H),37162425,50337013,27618177,115117615,1216953612.655900,2703461294.156300,1944555392.221100,5864970299.033300,354525,281139,290490,926154
2022-02-14,EDGA Equities (J),67222693,94681105,60818763,222722561,2901493965.907700,4809800195.145499,3694824077.006500,11406118238.059699,926932,645423,784475,2356830
2022-02-14,EDGX Equities (K),249950947,136451208,242782630,629184785,9610871998.084203,9864555357.336102,14531712367.526603,34007139722.946908,2193342,835429,2151069,5179840
2022-02-14,LTSE (L),3134,0,864,3998,1472689.050000,0.000000,9772.750000,1482461.800000,36,0,13,49
2022-02-14,NYSE Chicago (M),13679229,8649838,9564652,31893719,1001590248.673100,971030438.177800,2469774611.259100,4442395298.110000,40435,2847,33411,76693
2022-02-14,NYSE (N),1038841294,83397650,67931801,1190170745,56734087263.756304,5606371479.383799,3651359901.003800,65991818644.143903,4807536,288689,536090,5632315
2022-02-14,NYSE Arca (P),222020223,442511084,332863748,997395055,10092378406.732099,33985351439.667194,24142399838.722903,68220129685.122196,2404803,2157076,3481936,8043815
2022-02-14,NASDAQ (Q),551927530,363866925,1058171432,1973965887,28772394601.678697,32357728221.490998,80144743873.156589,141274866696.326284,6980584,2782538,9579845,19342967
2022-02-14,Members Exchange (U),193932712,179498422,158028188,531459322,5538758117.709303,11306453257.589199,7274719658.781001,24119931034.079503,1534832,824501,1354927,3714260
2022-02-14,Investors Exchange (V),135495517,35576849,109693663,280766029,8998499650.094499,2516726737.619000,8928867025.794597,20444093413.508096,1693085,231194,1354307,3278586
2022-02-14,NASDAQ PSX (X),30418265,54997439,33171653,118587357,1037091258.101600,3577742385.052899,2257254822.298200,6872088465.452699,274948,286229,367058,928235
2022-02-14,BYX Equities (Y),70539185,53529597,45554788,169623570,2046129882.093600,3843673126.763400,2495326434.196800,8385129443.053800,726744,306823,564989,1598556
2022-02-14,BZX Equities (Z),265362300,223910339,209891694,699164333,11576645011.072098,19421886090.246398,15045256548.759900,46043787650.078396,3132382,1511370,2718260,7362012
2022-02-11,NYSE American (A),18497752,37988019,14373734,70859505,819973748.392700,1553650309.505700,953687633.994100,3327311691.892500,192726,166565,139008,498299
2022-02-11,NASDAQ BX (B),25889683,23813321,27498625,77201629,1368558536.453800,2111721999.815700,2490865340.842701,5971145877.112201,455383,189079,473410,1117872
2022-02-11,NYSE National (C),51422336,54563669,32561556,138547561,1354238816.069700,2258194475.833500,1358880795.481600,4971314087.384800,506461,290925,392354,1189740
2022-02-11,FINRA / Nasdaq TRF Chicago (DB),10102769,4087988,15457234,29647991,459288483.817400,160847720.313700,1157322913.818000,1777459117.949100,50353,13552,87258,151163
2022-02-11,FINRA / NYSE TRF (DN),261796177,174598526,464906119,901300822,9703145781.281395,6422751645.569803,22450859037.304707,38576756464.155905,1386258,409896,1816885,3613039
2022-02-11,FINRA / Nasdaq TRF Carteret (DQ),1602327960,863653905,1847593990,4313575855,78149380995.911700,52230119831.189619,106552071814.843245,236931572641.944564,7669111,2622906,7967434,18259451
2022-02-11,MIAX Pearl (H),45342495,64569437,43144910,153056842,1357240982.266000,3469080510.328101,2641193703.442000,7467515196.036101,395559,308595,376210,1080364
2022-02-11,EDGA Equities (J),73060844,93411023,63377339,229849206,2945294966.652300,5038090735.325201,4150903770.216999,12134289472.194500,970041,675991,885105,2531137
2022-02-11,EDGX Equities (K),315114797,181160500,322528416,818803713,11637653604.384200,12033029017.267798,18917026037.128388,42587708658.780386,2653527,1074036,2832284,6559847
2022-02-11,LTSE (L),206686,32096,6350,245132,11009129.640000,6798745.440000,586916.610000,18394791.690000,90,125,27,242
2022-02-11,NYSE Chicago (M),10710264,8797343,8968926,28476533,860151263.945000,1301832931.450000,1702990244.529401,3864974439.924401,62766,3459,49199,115424
2022-02-11,NYSE (N),1086838363,105858685,82932537,1275629585,58504191999.044198,7373241353.031798,4990464070.018001,70867897422.093997,5208836,405616,669552,6284004
2022-02-11,NYSE Arca (P),262205555,546588918,402650079,1211444552,11458669084.373899,41564501874.389570,29376980632.868276,82400151591.631745,2692399,2673431,4168980,9534810
2022-02-11,NASDAQ (Q),642717348,454787598,1227819608,2325324554,32390101185.795914,38677407949.426699,93547403102.647286,164614912237.869899,7850526,3411287,11261082,22522895
2022-02-11,Members Exchange (U),226450916,203115209,191879004,621445129,6103276930.108001,12096686718.167405,8109754917.340801,26309718565.616207,1667458,851488,1527578,4046524
2022-02-11,Investors Exchange (V),167967534,47735445,131281233,346984212,10781361842.633499,3479340189.378199,11161417205.713003,25422119237.724701,2001126,274021,1644218,3919365
2022-02-11,NASDAQ PSX (X),38967567,75486111,38827200,153280878,1212765952.640800,4992894959.778701,2882955510.900901,9088616423.320402,317516,361633,421208,1100357
2022-02-11,BYX Equities (Y),88050571,69866491,55873611,213790673,2335991461.570900,4748294564.445000,2988940076.661499,10073226102.677399,795864,398767,668430,1863061
2022-02-11,BZX Equities (Z),323833615,290726933,265641744,880202292,13959164582.549200,24022861827.330510,19420294067.479204,57402320477.358914,3652004,1904916,3298289,8855209
2022-02-10,NYSE American (A),14952902,27014707,12876462,54844071,696570293.223300,1034474962.829600,812231019.693300,2543276275.746200,175448,119608,138274,433330
2022-02-10,NASDAQ BX (B),26008702,23029740,29359349,78397791,1437239480.130100,2112250284.107800,2742159927.032300,6291649691.270200,453643,188044,483025,1124712
2022-02-10,NYSE National (C),46745637,45271594,35135044,127152275,1321457968.843100,1922267855.021800,1350637933.382000,4594363757.246900,504252,221844,370446,1096542
2022-02-10,FINRA / Nasdaq TRF Chicago (DB),11630919,3882097,15269449,30782465,517967076.029100,185225975.054500,1127458461.721400,1830651512.805000,57050,13817,82197,153064
2022-02-10,FINRA / NYSE TRF (DN),299938164,146806047,438832472,885576683,11572073366.606796,6202720401.131698,21517938300.364510,39292732068.103004,1508777,356509,1728726,3594012
2022-02-10,FINRA / Nasdaq TRF Carteret (DQ),1735296340,838485949,1869812010,4443594299,85242676073.982596,57966718057.195328,109574767408.037411,252784161539.215335,8190231,2382207,7925223,18497661
2022-02-10,MIAX Pearl (H),44506030,46707753,38845978,130059761,1433164806.372900,2779203035.932200,2409916584.856000,6622284427.161100,422511,245574,390229,1058314
2022-02-10,EDGA Equities (J),74983876,76008974,66859647,217852497,3215586533.898000,4229122184.771602,4384149728.077701,11828858446.747303,1022007,531098,918127,2471232
2022-02-10,EDGX Equities (K),326342067,143616234,315914720,785873021,12675402022.049904,10173828314.516398,19453283918.203289,42302514254.769591,2830793,873396,2780144,6484333
2022-02-10,LTSE (L),153606,24000,132214,309820,8660266.380000,2990160.000000,17827581.720000,29478008.100000,134,4,635,773
2022-02-10,NYSE Chicago (M),13294743,7802603,8199266,29296612,897680717.065600,1354736440.475800,1696993019.267000,3949410176.808400,54620,4049,46028,104697
2022-02-10,NYSE (N),1026040535,63585607,84845601,1174471743,55105662603.631598,4786543041.346900,5413782856.206100,65305988501.184598,5076202,289884,693306,6059392
2022-02-10,NYSE Arca (P),259863598,433389527,407356804,1100609929,11596021306.621001,34832623521.734285,31397106544.569997,77825751372.925283,2705365,2198506,4199800,9103671
2022-02-10,NASDAQ (Q),630176332,361678701,1202628852,2194483885,32315256967.825401,33434130534.698085,90325740943.736412,156075128446.259898,7911851,2913874,11302573,22128298
2022-02-10,Members Exchange (U),209924116,157876902,183522443,551323461,5915550519.985201,10787883531.996698,7659038259.199900,24362472311.181799,1703686,735848,1527705,3967239
2022-02-10,Investors Exchange (V),186193464,39708491,139836702,365738657,11710414635.263300,3100023517.026900,11190257029.857702,26000695182.147902,2084793,233587,1663867,3982247
2022-02-10,NASDAQ PSX (X),32864257,49143056,37826338,119833651,1086969267.406900,3422054630.788701,2738439564.712099,7247463462.907700,310407,257722,445233,1013362
2022-02-10,BYX Equities (Y),77362481,59916125,58585435,195864041,2186674072.700600,4299174302.662100,3007698836.830600,9493547212.193300,767978,331546,674080,1773604
2022-02-10,BZX Equities (Z),298589985,220336860,266672366,785599211,13374401031.976896,19560215084.821110,18755989507.832600,51690605624.630606,3661321,1500872,3318973,8481166
2022-02-09,NYSE American (A),16155507,26657173,12590404,55403084,746016554.061600,902649602.595400,742912603.808100,2391578760.465100,180130,109067,131812,421009
2022-02-09,NASDAQ BX (B),22304529,16636781,22631822,61573132,1213750091.097500,1727666605.570500,2001111860.435001,4942528557.103001,411985,129020,416070,957075
2022-02-09,NYSE National (C),39911559,34843596,27890781,102645936,1145621295.319700,1583276507.913600,965890546.162700,3694788349.396000,442172,164665,313418,920255
2022-02-09,FINRA / Nasdaq TRF Chicago (DB),8640350,2393822,13741294,24775466,353159242.694700,108654165.675800,912064322.351700,1373877730.722200,42470,9493,73765,125728
2022-02-09,FINRA / NYSE TRF (DN),241150914,116048134,440716838,797915886,9288446879.586099,4191114101.846400,20120963767.231581,33600524748.664080,1352183,295144,1650409,3297736
2022-02-09,FINRA / Nasdaq TRF Carteret (DQ),1492107930,687973016,1814431029,3994511975,71606241003.603005,45814069584.959799,102242061347.230877,219662371935.793681,7494842,1941230,7483156,16919228
2022-02-09,MIAX Pearl (H),34125190,31118012,33039702,98282904,1069994778.642500,2777549730.077201,2166527440.249200,6014071948.968901,338761,170024,298109,806894
2022-02-09,EDGA Equities (J),66221578,52299128,53532687,172053393,2984453314.887700,2950011395.792400,3176359725.060601,9110824435.740701,935383,365640,772109,2073132
2022-02-09,EDGX Equities (K),263939111,96544810,277521713,638005634,10776731802.897596,6036800576.199596,15591089997.843703,32404622376.940895,2294131,537899,2325503,5157533
2022-02-09,LTSE (L),214906,135600,98341,448847,12593604.340000,24351638.000000,20512868.110000,57458110.450000,67,21,39,127
2022-02-09,NYSE Chicago (M),15167540,12351568,7792620,35311728,1266130225.454200,2075915878.860000,1759043942.574000,5101090046.888200,32090,2413,29536,64039
2022-02-09,NYSE (N),901875439,57272847,74976914,1034125200,49457236381.404603,4494724733.749899,4106889607.118800,58058850722.273302,3946698,218329,588042,4753069
2022-02-09,NYSE Arca (P),222909915,325637900,346245074,894792889,10694034356.915399,24504691161.825707,22384260643.809404,57582986162.550510,2292678,1455631,3397653,7145962
2022-02-09,NASDAQ (Q),519900376,245495390,1029741539,1795137305,27603112022.042306,21989428376.830614,72723264664.132103,122315805063.005023,6490504,1777103,9112610,17380217
2022-02-09,Members Exchange (U),187894752,103256395,160293810,451444957,5305308762.644700,6972427550.690398,6421039405.236602,18698775718.571700,1455549,495964,1306507,3258020
2022-02-09,Investors Exchange (V),156273561,31430435,123486955,311190951,10080889210.155901,2275625512.532401,9458724246.636705,21815238969.325007,1909742,222004,1516813,3648559
2022-02-09,NASDAQ PSX (X),29561883,38842607,29302069,97706559,1031115123.741300,3152742627.946799,1911298259.344900,6095156011.032999,277071,189487,355788,822346
2022-02-09,BYX Equities (Y),65763285,44699167,48942587,159405039,2013532441.726600,3262838772.883700,2293286781.224200,7569657995.834500,699173,253059,582680,1534912
2022-02-09,BZX Equities (Z),240233623,142449252,212755548,595438423,10945806739.921695,11833743964.537096,14174129874.389805,36953680578.848596,2946313,898064,2680625,6525002
2022-02-08,NYSE American (A),15747303,21702751,10967363,48417417,721699603.288800,809299062.434000,648807638.965400,2179806304.688200,186388,97393,128885,412666
2022-02-08,NASDAQ BX (B),20489172,14975575,21363817,56828564,1101033143.131900,1411940946.071800,1985327683.630900,4498301772.834600,395494,122314,387313,905121
2022-02-08,NYSE National (C),39311590,32524802,26739771,98576163,1135774558.898400,1434278024.927100,1004338659.719200,3574391243.544700,448396,155528,305070,908994
2022-02-08,FINRA / Nasdaq TRF Chicago (DB),7435977,2680638,11913183,22029798,311547591.518900,129454094.564100,903293539.820700,1344295225.903700,39274,8341,68294,115909
2022-02-08,FINRA / NYSE TRF (DN),228950733,110646246,387329213,726926192,8909225033.206705,4349873967.137401,19970094881.326983,33229193881.671089,1259761,272949,1576239,3108949
2022-02-08,FINRA / Nasdaq TRF Carteret (DQ),1544153088,644214835,1642705256,3831073179,77844091651.566838,41949819723.108590,101599737941.110852,221393649315.786280,7025633,1809395,6920575,15755603
2022-02-08,MIAX Pearl (H),31556129,30671456,24399921,86627506,1039091656.774800,2322779284.003099,1771824485.404100,5133695426.181999,324223,167995,273521,765739
2022-02-08,EDGA Equities (J),63633940,53589471,51624617,168848028,2838630579.896400,2943309243.157501,3354333276.044700,9136273099.098601,920481,375550,758099,2054130
2022-02-08,EDGX Equities (K),242721414,83143607,246150208,572015229,9633964557.972100,5524550564.398800,14817445695.006899,29975960817.377799,2165393,508811,2202423,4876627
2022-02-08,LTSE (L),5843,200,9255,15298,1072287.640000,4410.000000,113584.090000,1190281.730000,22,1,24,47
2022-02-08,NYSE Chicago (M),13722368,9180680,8576410,31479458,878627132.025200,795000395.616000,1174571186.363300,2848198714.004500,35191,2196,29332,66719
2022-02-08,NYSE (N),890398996,52744513,66179325,1009322834,48283055625.761995,4236341216.868799,3783924200.064100,56303321042.694894,4016923,210362,541883,4769168
2022-02-08,NYSE Arca (P),209312167,293545481,318311051,821168699,10204913297.564902,23057668412.894788,21295023420.444602,54557605130.904292,2238597,1424464,3242959,6906020
2022-02-08,NASDAQ (Q),505759207,229738246,954884180,1690381633,26245880141.848498,20176106378.244297,69389538844.795617,115811525364.888412,6384649,1797288,8797937,16979874
2022-02-08,Members Exchange (U),173978480,99450775,148987755,422417010,5212261828.315902,7013683179.100898,6320265989.130600,18546210996.547400,1446053,491823,1291020,3228896
2022-02-08,Investors Exchange (V),145418397,27149151,113873454,286441002,9275189237.892500,1959699223.038600,9149384753.788698,20384273214.719798,1760487,172691,1357928,3291106
2022-02-08,NASDAQ PSX (X),29758757,36431250,27782693,93972700,1013736120.631100,2418421843.070500,1820453976.147000,5252611939.848600,280686,188518,345888,815092
2022-02-08,BYX Equities (Y),63603434,39718868,43604101,146926403,1866727555.671600,3270573965.834899,2284102311.301101,7421403832.807600,682401,235328,549237,1466966
2022-02-08,BZX Equities (Z),233670510,133498073,188378360,555546943,10535810100.427999,11006573266.278098,12911919497.593284,34454302864.299381,2919329,909036,2488604,6316969
2022-02-07,NYSE American (A),15223421,20938126,9923526,46085073,761603125.537200,665200461.230000,701576282.223600,2128379868.990800,171509,93444,119627,384580
2022-02-07,NASDAQ BX (B),19331828,14643201,19843500,53818529,1106097079.441300,1280302142.779000,1982706385.112500,4369105607.332800,356887,113362,357469,827718
2022-02-07,NYSE National (C),36683177,29868339,25271481,91822997,1180004253.682500,1268194877.589500,1018252669.293700,3466451800.565700,429712,150355,301373,881440
2022-02-07,FINRA / Nasdaq TRF Chicago (DB),7621197,2178137,14068041,23867375,343409815.499900,106383238.989100,1066625505.457400,1516418559.946400,40252,8836,73783,122871
2022-02-07,FINRA / NYSE TRF (DN),231512926,105977474,401970244,739460644,9175188495.749696,4027487403.496801,19864642597.393704,33067318496.640201,1338116,290149,1727992,3356257
2022-02-07,FINRA / Nasdaq TRF Carteret (DQ),1415790787,612263652,1644353694,3672408133,69160663723.662789,38632309662.988506,98179502994.110232,205972476380.761527,7043669,1947880,7092037,16083586
2022-02-07,MIAX Pearl (H),33278732,31942544,23433225,88654501,1077501524.070400,2217560203.801699,1523596143.855200,4818657871.727299,327291,181428,260509,769228
2022-02-07,EDGA Equities (J),60252868,53092993,47747336,161093197,2678958435.684400,2921891915.616901,3126559189.173601,8727409540.474902,852233,376301,699214,1927748
2022-02-07,EDGX Equities (K),231109106,89050570,248830119,568989795,9091508450.840900,5945579379.619700,14437205589.949407,29474293420.410007,2051685,537825,2163815,4753325
2022-02-07,LTSE (L),651,200,6256,7107,429827.950000,4402.000000,1434852.730000,1869082.680000,13,1,55,69
2022-02-07,NYSE Chicago (M),15500537,8802320,7381831,31684688,1109789020.984100,990959037.540000,1368792954.791200,3469541013.315300,38577,2657,33793,75027
2022-02-07,NYSE (N),881651607,56601160,67494646,1005747413,48790371040.253288,4253882875.507900,3812012713.926499,56856266629.687687,3849110,217536,531813,4598459
2022-02-07,NYSE Arca (P),196339277,304797596,298993008,800129881,9015945667.762702,23928024355.909995,21278307527.916510,54222277551.589207,2101238,1467975,3090994,6660207
2022-02-07,NASDAQ (Q),469931956,240167524,951085892,1661185372,23824310546.000696,21649800402.576602,69382772951.375403,114856883899.952701,5942138,1866680,8512223,16321041
2022-02-07,Members Exchange (U),169308942,98713368,148394537,416416847,5051380757.727200,7219151661.289001,6025970993.304000,18296503412.320201,1388092,511109,1230749,3129950
2022-02-07,Investors Exchange (V),139167096,27130259,108437590,274734945,8734545931.615200,1882257818.060500,9078403290.600402,19695207040.276102,1661660,171686,1340733,3174079
2022-02-07,NASDAQ PSX (X),26900232,35505802,26968187,89374221,996789731.939700,2686883192.878099,1843887842.676200,5527560767.493999,262892,197986,325074,785952
2022-02-07,BYX Equities (Y),61051331,39717687,42878708,143647726,1842289426.680000,3083134592.031401,2207863242.235500,7133287260.946901,643797,236303,519410,1399510
2022-02-07,BZX Equities (Z),217831959,138477115,181649161,537958235,9745815825.699500,11598515111.376501,12273823377.553796,33618154314.629797,2713036,972533,2351775,6037344
2022-02-04,NYSE American (A),15264466,29409499,10229934,54903899,716888783.970400,945254667.313000,879412532.238400,2541555983.521800,168964,117386,124003,410353
2022-02-04,NASDAQ BX (B),21994028,17506358,20456701,59957087,1171048035.131300,1610760845.456800,2517510267.540100,5299319148.128200,392051,156553,379259,927863
2022-02-04,NYSE National (C),43352114,38398886,28592565,110343565,1290193875.556900,1731686721.553700,1407817400.873500,4429697997.984100,474533,194287,326629,995449
2022-02-04,FINRA / Nasdaq TRF Chicago (DB),8712071,2918752,11187518,22818341,367795910.962900,128400761.693400,1067657216.864000,1563853889.520300,45898,10897,62884,119679
2022-02-04,FINRA / NYSE TRF (DN),265904794,128173609,342462381,736540784,9847385077.182606,5611696899.039597,20801383851.805288,36260465828.027491,1399646,331180,1540364,3271190
2022-02-04,FINRA / Nasdaq TRF Carteret (DQ),1549275379,729266120,1489770824,3768312323,74847949522.485612,48028955747.890209,104502931174.930596,227379836445.306417,7443576,2111433,6868402,16423411
2022-02-04,MIAX Pearl (H),43395578,43584485,24770284,111750347,1312719501.167700,2663381548.231600,1830579749.259100,5806680798.658400,362365,244178,280625,887168
2022-02-04,EDGA Equities (J),69364529,68293186,55074809,192732524,3002580088.056000,4013704247.950900,4117407682.076300,11133692018.083200,931608,486764,766026,2184398
2022-02-04,EDGX Equities (K),280418943,118830145,231228681,630477769,10708447891.741600,8354799321.743100,18252131517.974808,37315378731.459508,2334167,722296,2188770,5245233
2022-02-04,LTSE (L),921,100,5309,6330,927522.350000,4382.440000,54690.660000,986595.450000,36,2,7,45
2022-02-04,NYSE Chicago (M),9324477,10930701,11778713,32033891,680774819.516100,1423213444.719000,2432208317.352000,4536196581.587100,31875,2000,29192,63067
2022-02-04,NYSE (N),943819311,71692496,71976520,1087488327,52054557976.581489,5512430457.177801,4906723299.132499,62473711732.891789,4428289,285995,565332,5279616
2022-02-04,NYSE Arca (P),232342191,399742576,308037720,940122487,10594681906.398501,31517953676.238073,28635590471.058898,70748226053.695472,2391557,1857016,3330862,7579435
2022-02-04,NASDAQ (Q),535344849,297345185,970742976,1803433010,27296167237.198003,26869235328.506906,84676909976.863519,138842312542.568428,6540297,2293613,9126008,17959918
2022-02-04,Members Exchange (U),180263511,126278402,149391497,455933410,5446472870.873501,9041372077.957902,7067815976.100301,21555660924.931704,1467663,606170,1270456,3344289
2022-02-04,Investors Exchange (V),155362040,32020406,118722638,306105084,10065455023.387100,2529326807.146600,11992234313.238002,24587016143.771702,1755706,204768,1406539,3367013
2022-02-04,NASDAQ PSX (X),29052105,42845142,28196843,100094090,1041438663.729800,3589913838.723200,2430056482.947300,7061408985.400300,284914,247102,359591,891607
2022-02-04,BYX Equities (Y),67832699,47893984,44287204,160013887,1975611798.237100,3652603154.975800,2792085041.483499,8420299994.696399,690617,300936,535881,1527434
2022-02-04,BZX Equities (Z),255272181,177175763,204431263,636879207,11480779983.912401,15680580866.816800,17492542616.842097,44653903467.571298,3050429,1215706,2641217,6907352
2022-02-03,NYSE American (A),16843431,25680446,11693481,54217358,838429677.094800,1027026228.048300,1119409211.704600,2984865116.847700,191030,112840,142027,445897
2022-02-03,NASDAQ BX (B),21249396,18275520,23218101,62743017,1172257121.751900,1972495147.982701,2711567264.080200,5856319533.814801,369239,148156,425711,943106
2022-02-03,NYSE National (C),40581875,36139475,28582005,105303355,1208382812.358700,1557304906.487900,1395390298.713800,4161078017.560400,429614,184443,324458,938515
2022-02-03,FINRA / Nasdaq TRF Chicago (DB),7712304,2749817,11857039,22319160,307265948.135000,130032006.293700,1267713756.162200,1705011710.590900,37923,11045,77913,126881
2022-02-03,FINRA / NYSE TRF (DN),213821924,120034347,340381645,674237916,8088159345.380202,5142832494.685701,23630072766.407096,36861064606.472999,1217745,323926,1701364,3243035
2022-02-03,FINRA / Nasdaq TRF Carteret (DQ),1402567411,683226579,1548960720,3634754710,69395759645.193689,47666584121.834585,122243889526.061150,239306233293.089424,7204944,2091309,7791525,17087778
2022-02-03,MIAX Pearl (H),34625923,39935722,24238247,98799892,1124597739.512500,2439445390.215500,2101436324.082400,5665479453.810400,331613,212415,291834,835862
2022-02-03,EDGA Equities (J),65033504,70781131,60307223,196121858,2946381400.588700,5025619687.170000,5265002334.968298,13237003422.726998,904225,512100,864324,2280649
2022-02-03,EDGX Equities (K),253683372,113146421,245529575,612359368,9857471304.339302,8274474078.023302,19742717569.246499,37874662951.609103,2293914,715471,2482966,5492351
2022-02-03,LTSE (L),33278,1649,122994,157921,3935054.730000,49649.370000,20547030.660000,24531734.760000,418,41,1652,2111
2022-02-03,NYSE Chicago (M),10992927,8358843,11474001,30825771,712005879.861000,1144003691.855600,2759318507.341501,4615328079.058101,39392,2222,37425,79039
2022-02-03,NYSE (N),906386642,68418147,66950426,1041755215,50404317764.297396,5451759828.122899,4975231671.876300,60831309264.296595,4273983,274490,597932,5146405
2022-02-03,NYSE Arca (P),230682062,392453536,337303027,960438625,10930498401.152203,31915468102.533778,36741472392.833106,79587438896.519087,2434424,1920233,3835792,8190449
2022-02-03,NASDAQ (Q),532508524,290783583,1060519994,1883812101,27793422028.746604,26882008439.565717,100176473516.912636,154851903985.224957,6609161,2349352,10096077,19054590
2022-02-03,Members Exchange (U),174662396,122148096,147141893,443952385,5245854645.113800,9044663481.752199,7616238039.733997,21906756166.599996,1445177,594611,1318874,3358662
2022-02-03,Investors Exchange (V),153430364,31596293,123071646,308098303,10055843477.656500,2490049803.016001,13540810047.884607,26086703328.557108,1738168,191518,1509724,3439410
2022-02-03,NASDAQ PSX (X),29770883,42655741,30573000,102999624,1074847605.248000,3469633472.114000,2758884740.196500,7303365817.558500,295007,250403,402828,948238
2022-02-03,BYX Equities (Y),64282100,46502202,47462306,158246608,1916132771.653800,3624978127.114001,2934246151.846500,8475357050.614301,670888,277766,585492,1534146
2022-02-03,BZX Equities (Z),243102510,180280100,206913734,630296344,11092715936.786602,15819237976.692901,18350124518.782199,45262078432.261702,3037297,1235084,2855466,7127847
2022-02-02,NYSE American (A),15745935,24061302,10797352,50604589,726483007.743000,925374017.985400,755129091.592500,2406986117.320900,178007,109655,130319,417981
2022-02-02,NASDAQ BX (B),19711303,17498068,22775348,59984719,1126607269.766800,1666160103.534000,2588750095.987700,5381517469.288500,378666,155022,436335,970023
2022-02-02,NYSE National (C),42363443,35984584,29196975,107545002,1208954626.861900,1498234532.474000,1329280278.088800,4036469437.424700,464205,188811,339824,992840
2022-02-02,FINRA / Nasdaq TRF Chicago (DB),7022008,2588117,13365988,22976113,307279037.869400,148956544.251500,1310318645.587200,1766554227.708100,35812,10938,81874,128624
2022-02-02,FINRA / NYSE TRF (DN),211849493,114743300,416839796,743432589,8393368075.410297,5385894817.676099,24022601310.664683,37801864203.751079,1266620,309675,1779590,3355885
2022-02-02,FINRA / Nasdaq TRF Carteret (DQ),1500131174,664567781,1707894895,3872593850,76162270893.634006,49350702938.412672,119683860771.991892,245196834604.038570,7231610,2088511,7775955,17096076
2022-02-02,MIAX Pearl (H),31321570,38157619,22978292,92457481,1031556074.431300,2249553663.471000,1873578993.610500,5154688731.512800,316674,200648,279635,796957
2022-02-02,EDGA Equities (J),71043878,70727808,62292338,204064024,3261664380.667800,4373216277.422398,4503387560.271300,12138268218.361498,1019944,518464,908269,2446677
2022-02-02,EDGX Equities (K),241815421,107435751,277644443,626895615,10000097451.778599,8285127506.842006,18621034596.937790,36906259555.558395,2258447,672875,2535204,5466526
2022-02-02,LTSE (L),44621,40611,31825,117057,4337333.280000,5139336.530000,3109672.450000,12586342.260000,376,12,456,844
2022-02-02,NYSE Chicago (M),13959828,12354005,13924796,40238629,893098006.248400,2615312329.175000,2374941896.312100,5883352231.735500,46338,3010,42675,92023
2022-02-02,NYSE (N),986524540,63446916,71474417,1121445873,55557800416.995499,4931815194.439000,4792107783.769100,65281723395.203599,4439634,255790,610614,5306038
2022-02-02,NYSE Arca (P),213265426,354511085,357184650,924961161,10223809959.190098,28662570185.244796,33276369294.571691,72162749439.006585,2315479,1786467,4004370,8106316
2022-02-02,NASDAQ (Q),502139330,277713500,1106957746,1886810576,26986021475.010502,25897321238.296504,90686364741.219427,143569707454.526433,6567821,2250490,10057541,18875852
2022-02-02,Members Exchange (U),154144835,104022010,147627154,405793999,4406525447.528701,7948551180.233300,6607150171.454100,18962226799.216101,1263168,511420,1226977,3001565
2022-02-02,Investors Exchange (V),147308730,30805385,121170858,299284973,9780060552.461598,2360100897.534100,11943280722.286701,24083442172.282399,1817801,190585,1525130,3533516
2022-02-02,NASDAQ PSX (X),27954214,41847718,31261012,101062944,943245272.857800,3371741877.541000,2394541714.806399,6709528865.205199,263826,240537,371072,875435
2022-02-02,BYX Equities (Y),64157536,46264071,47440425,157862032,1928968734.456900,3761083104.600499,2750097763.920600,8440149602.977999,714538,285600,611693,1611831
2022-02-02,BZX Equities (Z),231085770,156547351,212284820,599917941,10910255740.104199,14009764999.641293,16446918867.143297,41366939606.888789,3014733,1112833,2885771,7013337
2022-02-01,NYSE American (A),17799304,26398038,10921658,55119000,844953120.624000,909207536.719600,684535321.957800,2438695979.301400,209238,114757,135419,459414
2022-02-01,NASDAQ BX (B),20883717,20032661,21156086,62072464,1254578071.952000,1803786421.607000,2118531745.873800,5176896239.432800,413688,151589,378855,944132
2022-02-01,NYSE National (C),43924365,42334069,30090691,116349125,1337305201.007000,1852307085.592900,1363907785.273400,4553520071.873300,503920,200964,334572,1039456
2022-02-01,FINRA / Nasdaq TRF Chicago (DB),9598273,2835023,14089807,26523103,389445734.132700,136689259.366000,1003161474.801200,1529296468.299900,45973,11900,70541,128414
2022-02-01,FINRA / NYSE TRF (DN),253499413,120576996,429188843,803265252,9731521962.721803,5727854838.245996,21009148978.753012,36468525779.720811,1402855,329708,1683373,3415936
2022-02-01,FINRA / Nasdaq TRF Carteret (DQ),1576250767,783636744,1740797798,4100685309,77073125611.734285,59036984215.205399,98796838611.062716,234906948438.002400,7814072,2209034,7390831,17413937
2022-02-01,MIAX Pearl (H),38713937,38240099,24769106,101723142,1257434488.310100,2862324569.063599,1637152459.251500,5756911516.625199,379818,224346,276962,881126
2022-02-01,EDGA Equities (J),73851565,79123172,58829407,211804144,3164218841.085600,5411613385.978001,4367578195.548198,12943410422.611799,1021421,570383,832011,2423815
2022-02-01,EDGX Equities (K),278268374,112002511,273002911,663273796,10861227834.031703,8415427488.056703,15884754292.180497,35161409614.268903,2440296,700611,2365517,5506424
2022-02-01,LTSE (L),451068,306,3873,455247,4783463.340000,51097.060000,238668.140000,5073228.540000,29,4,64,97
2022-02-01,NYSE Chicago (M),9862148,13065177,12028242,34955567,769452848.832800,1574862577.528200,2003905811.507200,4348221237.868200,53171,3270,44280,100721
2022-02-01,NYSE (N),1010078374,63127504,74680319,1147886197,55484296603.646888,4628522330.247001,3755404996.147900,63868223930.041789,4666010,243577,594852,5504439
2022-02-01,NYSE Arca (P),238649647,371109756,335801768,945561171,10966080380.387002,30511622253.283402,27840073159.740203,69317775793.410607,2513204,1805817,3683497,8002518
2022-02-01,NASDAQ (Q),547200074,293452097,1065446095,1906098266,28058803936.273211,27288541052.645893,79272405447.492488,134619750436.411592,6942002,2320475,9803699,19066176
2022-02-01,Members Exchange (U),187153877,120121751,165316576,472592204,5742089968.307000,9010395314.644099,6818616137.316300,21571101420.267399,1565871,588017,1363598,3517486
2022-02-01,Investors Exchange (V),157075159,36648350,122848812,316572321,10356818255.560400,2689594317.487700,9931618429.387002,22978031002.435102,1981286,215404,1559100,3755790
2022-02-01,NASDAQ PSX (X),31067595,42763475,29814637,103645707,1095396998.823100,3473508258.452701,2042611896.878100,6611517154.153901,283495,240700,328372,852567
2022-02-01,BYX Equities (Y),64385027,51097713,47735918,163218658,2050560817.828800,3890474825.928000,2514046161.458500,8455081805.215300,746478,304217,586137,1636832
2022-02-01,BZX Equities (Z),258120057,175621262,215334117,649075436,11794728445.369594,15995416435.904996,14687741240.308000,42477886121.582590,3324651,1217481,2848253,7390385
2022-01-31,NYSE American (A),16908704,27156310,12846212,56911226,825892365.089500,1082850994.601600,896129816.579900,2804873176.271000,196813,119986,153919,470718
2022-01-31,NASDAQ BX (B),19405817,20419365,22514953,62340135,1115981754.728700,2144990257.943501,2449279232.688001,5710251245.360202,380975,167853,417904,966732
2022-01-31,NYSE National (C),45244515,39777186,30819393,115841094,1315678385.091800,1982920472.057400,1172390558.640500,4470989415.789700,495435,202471,353902,1051808
2022-01-31,FINRA / Nasdaq TRF Chicago (DB),8473400,3350921,14853956,26678277,329887863.291200,154225809.851200,1088721360.980900,1572835034.123300,42076,12645,85397,140118
2022-01-31,FINRA / NYSE TRF (DN),226025722,124346744,435691510,786063976,8965250090.095805,5845121310.843399,21986296465.410501,36796667866.349705,1389875,353583,1875185,3618643
2022-01-31,FINRA / Nasdaq TRF Carteret (DQ),1532516158,867510520,1803679088,4203705766,76361838996.072810,69908799263.010017,108769735161.357790,255040373420.440617,7697675,2449596,7989640,18136911
2022-01-31,MIAX Pearl (H),38810226,39304757,27300910,105415893,1181823687.401900,2913441591.482900,2155652946.435200,6250918225.320000,370513,230447,319922,920882
2022-01-31,EDGA Equities (J),69953748,69867838,58301715,198123301,3116271474.619500,4491134242.244999,4106364400.502400,11713770117.366899,979144,504438,833166,2316748
2022-01-31,EDGX Equities (K),254918145,127872037,283293835,666084017,9981882618.136701,9178906407.880800,16811621572.642108,35972410598.659609,2273765,710072,2490470,5474307
2022-01-31,LTSE (L),101,803,7344,8248,5978.110000,20220.620000,786147.350000,812346.080000,2,10,28,40
2022-01-31,NYSE Chicago (M),15690171,10955235,19412809,46058215,1141668945.679800,2146692228.270300,3101619872.256900,6389981046.207000,43127,3185,42903,89215
2022-01-31,NYSE (N),1401466796,68285912,81608779,1551361487,77227479831.139784,5846567382.307700,4852273648.869401,87926320862.316885,4613636,280856,654109,5548601
2022-01-31,NYSE Arca (P),219870244,399813031,366408285,986091560,10365371014.612808,33643769318.539203,26106376471.222106,70115516804.374117,2378614,1823448,3653432,7855494
2022-01-31,NASDAQ (Q),554767400,300980456,1349697936,2205445792,28993780577.655897,29295654304.253789,99405297044.409155,157694731926.318841,7004542,2416473,10325671,19746686
2022-01-31,Members Exchange (U),180984406,123247652,171038215,475270273,5565648835.855600,10064798241.716502,7703943229.145301,23334390306.717403,1542553,638234,1488613,3669400
2022-01-31,Investors Exchange (V),163231808,43574656,136788226,343594690,10842022703.258298,3603001915.060700,11385937492.732803,25830962111.051801,2042721,268675,1722036,4033432
2022-01-31,NASDAQ PSX (X),29882185,47472534,32860605,110215324,1037647467.307100,4149770235.266901,2230873618.835200,7418291321.409201,285098,277316,372237,934651
2022-01-31,BYX Equities (Y),65844782,54262428,48779285,168886495,1945922177.830900,4017432377.970499,2580835679.748300,8544190235.549699,717663,301832,604059,1623554
2022-01-31,BZX Equities (Z),254622856,177662215,229044638,661329709,11510296802.686097,16293634884.515701,15920940874.990197,43724872562.191995,3202809,1238460,2974469,7415738
2022-01-28,NYSE American (A),19219522,27617911,11672447,58509880,808751092.285600,1105805559.893100,723118704.934300,2637675357.113000,207394,134595,145633,487622
2022-01-28,NASDAQ BX (B),24414779,22692693,26393138,73500610,1318962881.199600,2027745148.534600,2347064757.808800,5693772787.543000,442237,205850,449940,1098027
2022-01-28,NYSE National (C),49484489,44972470,32130506,126587465,1441462685.443500,2113869359.540000,1322437789.338500,4877769834.322000,525467,255508,365441,1146416
2022-01-28,FINRA / Nasdaq TRF Chicago (DB),8427557,3531924,14696249,26655730,327001081.700900,147677534.484000,1155014963.763799,1629693579.948699,40231,12232,78785,131248
2022-01-28,FINRA / NYSE TRF (DN),239391457,144702897,410867234,794961588,9128319232.138706,7452695659.755601,21908036880.874882,38489051772.769189,1363677,376805,1778133,3518615
2022-01-28,FINRA / Nasdaq TRF Carteret (DQ),1505520449,860272310,1751483725,4117276484,73578715056.735170,58469850971.547401,104877941729.739608,236926507758.022179,7796993,2575766,7796749,18169508
2022-01-28,MIAX Pearl (H),45559182,62758548,30075547,138393277,1307824254.502000,3626535080.821801,2100722511.736300,7035081847.060101,401755,363721,348299,1113775
2022-01-28,EDGA Equities (J),79943431,95879593,65579142,241402166,3438816842.475700,5946193514.730301,4788603793.042501,14173614150.248502,1052733,745803,908492,2707028
2022-01-28,EDGX Equities (K),293477651,146283226,289155755,728916632,11533742174.427193,12287585444.466701,18314837036.456793,42136164655.350687,2591699,1037076,2683349,6312124
2022-01-28,LTSE (L),16376,605,75695,92676,2369478.990000,9981.000000,15851514.270000,18230974.260000,38,8,560,606
2022-01-28,NYSE Chicago (M),17794142,10518820,12829270,41142232,1905477641.760200,1700943687.045000,2831751400.963698,6438172729.768898,66368,3862,53260,123490
2022-01-28,NYSE (N),1063428027,82998890,78071494,1224498411,57309009078.637211,5725193834.641100,4513367226.432401,67547570139.710712,5296673,349026,667434,6313133
2022-01-28,NYSE Arca (P),248825951,466923265,381813780,1097562996,11952371816.567098,39917281471.222618,29347141595.172703,81216794882.962419,2688928,2533483,4017373,9239784
2022-01-28,NASDAQ (Q),625292562,415128074,1200971110,2241391746,31241550321.835695,40294304040.066007,92982243734.323660,164518098096.225362,7638387,3516507,11200544,22355438
2022-01-28,Members Exchange (U),219819453,152590401,182408953,554818807,6600466028.555000,12186291771.710001,8879432246.617601,27666190046.882602,1771967,835304,1602957,4210228
2022-01-28,Investors Exchange (V),173000974,38900271,138445436,350346681,11175800916.363401,3434108484.483401,11432701328.620302,26042610729.467104,2114498,238360,1713128,4065986
2022-01-28,NASDAQ PSX (X),36919404,57551885,34266203,128737492,1202983494.974400,4080263339.590900,2221673776.253000,7504920610.818300,295870,369805,382385,1048060
2022-01-28,BYX Equities (Y),79517452,53990841,52054314,185562607,2320249460.141500,4241289149.765900,2738867059.446301,9300405669.353701,775587,356426,633843,1765856
2022-01-28,BZX Equities (Z),301046190,241036863,258940317,801023370,13493113061.210099,24177140387.702388,18886068778.050194,56556322226.962681,3558947,1886657,3316129,8761733
2022-01-27,NYSE American (A),20441122,29498191,13679854,63619167,897586451.184300,1291937756.014600,870137302.806400,3059661510.005300,207238,149140,150857,507235
2022-01-27,NASDAQ BX (B),22729483,24573462,26772112,74075057,1370728267.464400,2308621845.731100,2499662933.998600,6179013047.194100,419124,237922,443136,1100182
2022-01-27,NYSE National (C),54952489,46841235,36258031,138051755,1520133360.270500,2119776946.174300,1487970455.643500,5127880762.088300,547511,258670,384448,1190629
2022-01-27,FINRA / Nasdaq TRF Chicago (DB),9754181,3505714,15690665,28950560,353366197.714100,153928940.767900,1334913676.773500,1842208815.255500,44098,14146,86519,144763
2022-01-27,FINRA / NYSE TRF (DN),246686061,151156773,421481049,819323883,9157611150.553702,6736482445.553302,23678718827.102093,39572812423.209097,1431214,414479,1939882,3785575
2022-01-27,FINRA / Nasdaq TRF Carteret (DQ),1569161254,930342278,1821403753,4320907285,74999834659.656231,59920142876.752109,110297548230.966808,245217525767.375148,8013158,2706271,8344691,19064120
2022-01-27,MIAX Pearl (H),46181520,62135315,31576285,139893120,1369621653.603100,3472688155.346100,2394775070.742099,7237084879.691299,420081,341119,373930,1135130
2022-01-27,EDGA Equities (J),80242346,103472222,68762920,252477488,3519598210.945900,6823657342.906997,5128050021.892299,15471305575.745196,1087398,825402,946668,2859468
2022-01-27,EDGX Equities (K),302529791,162796899,310658612,775985302,11485702937.894001,12865480013.366401,19369331028.250596,43720513979.510998,2684608,1137337,2872420,6694365
2022-01-27,LTSE (L),13208,903,11068,25179,603354.810000,23154.110000,870468.550000,1496977.470000,10,12,97,119
2022-01-27,NYSE Chicago (M),12530288,9214137,12446330,34190755,1002159156.499800,1507548407.221100,2418269830.936200,4927977394.657100,78369,3586,56259,138214
2022-01-27,NYSE (N),1075602623,91795643,84244002,1251642268,57727654707.274900,6328027346.232400,4505552535.329300,68561234588.836600,5428218,389405,685195,6502818
2022-01-27,NYSE Arca (P),269742460,504790059,419023874,1193556393,12731099549.323103,39220859350.839903,31547588229.505103,83499547129.668109,2911021,2712327,4399509,10022857
2022-01-27,NASDAQ (Q),672570931,443072612,1217456559,2333100102,34758498761.391694,41345871262.299303,93461597772.626580,169565967796.317577,8479194,3787777,11776137,24043108
2022-01-27,Members Exchange (U),219630284,163669313,186441723,569741320,6375680500.735700,12614902713.686595,8326070840.271599,27316654054.693894,1749429,870000,1572416,4191845
2022-01-27,Investors Exchange (V),180690629,36902175,147254750,364847554,11938198417.639600,3043104138.285200,12470598489.187399,27451901045.112199,2227214,251955,1798198,4277367
2022-01-27,NASDAQ PSX (X),41264002,64294708,39058891,144617601,1458144254.783400,4357931677.987400,2399202604.915201,8215278537.686001,370499,416754,438359,1225612
2022-01-27,BYX Equities (Y),77388994,57618524,54807002,189814520,2397220908.200900,4269182746.330301,2981057269.700701,9647460924.231902,794346,368282,654564,1817192
2022-01-27,BZX Equities (Z),312094649,258292942,270353818,840741409,13888065325.060901,24876468261.140900,19695100740.929691,58459634327.131492,3841390,1992944,3525116,9359450
2022-01-26,NYSE American (A),19369339,34178613,13347141,66895093,908633287.618000,1611746071.712000,991381377.053200,3511760736.383200,202808,167698,153454,523960
2022-01-26,NASDAQ BX (B),23235500,28958040,27262452,79455992,1415828316.530100,2501833019.023300,2722766941.750300,6640428277.303700,421943,277457,456957,1156357
2022-01-26,NYSE National (C),50217881,45557156,36041647,131816684,1506444698.553400,2219395839.828900,1621408909.561600,5347249447.943900,513742,270443,373038,1157223
2022-01-26,FINRA / Nasdaq TRF Chicago (DB),8286830,3615244,14702392,26604466,352756406.516100,171982872.327400,1135463059.939600,1660202338.783100,39558,14405,74719,128682
2022-01-26,FINRA / NYSE TRF (DN),271686547,150075944,496074788,917837279,10239177948.890202,7013907444.297398,24309216408.499298,41562301801.686898,1543025,416229,1960642,3919896
2022-01-26,FINRA / Nasdaq TRF Carteret (DQ),1668891644,858368710,2015058952,4542319306,80058858748.218035,57867810607.886721,116182068550.323840,254108737906.428596,8139780,2740408,8343446,19223634
2022-01-26,MIAX Pearl (H),39278552,63521835,33259433,136059820,1238995813.454200,4613986377.221499,2485693826.447700,8338676017.123399,369706,360248,328661,1058615
2022-01-26,EDGA Equities (J),91135456,122434719,80025070,293595245,4035019028.785699,7819319744.714697,5298886857.220499,17153225630.720895,1193039,993457,1023646,3210142
2022-01-26,EDGX Equities (K),341339879,198070277,347578557,886988713,13174405543.564903,16304331630.573898,21523434372.554709,51002171546.693510,2867362,1450028,2999859,7317249
2022-01-26,LTSE (L),784,1684,9140,11608,554911.490000,113998.680000,389296.340000,1058206.510000,12,13,55,80
2022-01-26,NYSE Chicago (M),27922168,8887895,17789843,54599906,1745771873.615200,1381049308.588400,3141168089.702899,6267989271.906499,123989,2703,99584,226276
2022-01-26,NYSE (N),1152630498,106757801,88929553,1348317852,61869725866.270008,7705114376.498600,5134003212.950000,74708843455.718608,5510744,450632,731140,6692516
2022-01-26,NYSE Arca (P),274078947,578741572,460012833,1312833352,13224175390.904899,48174479632.945985,37579130481.593118,98977785505.444002,2903499,3183443,4553184,10640126
2022-01-26,NASDAQ (Q),719406712,563352561,1362103084,2644862357,37649487859.319803,54261511102.468503,109184946319.287585,201095945281.075891,8681418,4758254,12303940,25743612
2022-01-26,Members Exchange (U),231343494,187645129,208742166,627730789,6940793881.552499,14094924234.748602,8767682475.257497,29803400591.558598,1816157,912931,1634991,4364079
2022-01-26,Investors Exchange (V),188517820,40472501,158065599,387055920,12432651003.645300,3606269200.068001,13756921229.144701,29795841432.858002,2277783,261113,1946355,4485251
2022-01-26,NASDAQ PSX (X),42667682,78309646,40425779,161403107,1504470167.311200,5538027318.540398,2907881215.146000,9950378700.997598,325785,504033,402876,1232694
2022-01-26,BYX Equities (Y),86521859,63087245,64805690,214414794,2752045766.687100,5022330950.777200,3535891230.231201,11310267947.695501,819066,413531,704021,1936618
2022-01-26,BZX Equities (Z),334112521,338275408,306913864,979301793,14789907124.547797,33366355269.848310,24147402032.218913,72303664426.615020,3916035,2648697,3805079,10369811
2022-01-25,NYSE American (A),19163432,32387196,12659702,64210330,885808904.204800,1263400721.260900,905096444.449200,3054306069.914900,210410,160403,157551,528364
2022-01-25,NASDAQ BX (B),22941654,25662500,29494594,78098748,1356522075.128100,2531847207.837199,2752164992.873900,6640534275.839199,423707,225720,480942,1130369
2022-01-25,NYSE National (C),56902965,46391002,34648831,137942798,1579492392.771400,2144763600.955800,1315896965.893100,5040152959.620300,559732,264902,384917,1209551
2022-01-25,FINRA / Nasdaq TRF Chicago (DB),7620003,3706329,13697269,25023601,329506758.031300,175639857.742200,955614629.632800,1460761245.406300,37272,13455,69130,119857
2022-01-25,FINRA / NYSE TRF (DN),228257148,135674577,413655130,777586855,9726164884.301501,6543925758.055798,21899719347.668399,38169809990.025698,1408916,403019,1732776,3544711
2022-01-25,FINRA / Nasdaq TRF Carteret (DQ),1542988884,841301884,1750995013,4135285781,79525233748.583483,61428073571.948151,103592936991.522277,244546244312.053911,8057225,2781656,7739684,18578565
2022-01-25,MIAX Pearl (H),46233169,75564238,30173404,151970811,1408596038.375500,4603710346.142100,2022916026.483100,8035222411.000700,421991,403061,317547,1142599
2022-01-25,EDGA Equities (J),79981958,120789701,70167437,270939096,3541300505.164100,7077077621.217702,4742960106.807401,15361338233.189203,1077045,918702,956007,2951754
2022-01-25,EDGX Equities (K),277542982,164666628,286864459,729074069,11008682082.045902,13948869929.417403,17915588909.285497,42873140920.748802,2501788,1200015,2622044,6323847
2022-01-25,LTSE (L),611,300,6924,7835,456605.730000,5545.000000,177357.960000,639508.690000,18,3,65,86
2022-01-25,NYSE Chicago (M),18439000,7398438,12933548,38770986,1468439268.129600,936402873.539000,2553142121.117901,4957984262.786501,99716,3556,78542,181814
2022-01-25,NYSE (N),1153952947,97731954,83041425,1334726326,65035426022.663811,6879360318.881700,4996335886.097599,76911122227.643110,5868748,417064,731512,7017324
2022-01-25,NYSE Arca (P),254670956,539399531,410438093,1204508580,12751616981.052397,43565116250.457415,34113339049.696189,90430072281.206001,2841144,2850812,4364094,10056050
2022-01-25,NASDAQ (Q),629825201,477196101,1211612879,2318634181,33093483937.162604,44069209714.205897,97255762549.730692,174418456201.099193,8176226,4036924,11539947,23753097
2022-01-25,Members Exchange (U),212411969,190833241,181856715,585101925,6391464993.120699,13785318043.264296,7869326176.544301,28046109212.929296,1728103,920940,1472779,4121822
2022-01-25,Investors Exchange (V),179107433,37528697,134826975,351463105,12124472603.933997,3347298628.216500,11191634860.420499,26663406092.570996,2230446,264384,1776544,4271374
2022-01-25,NASDAQ PSX (X),36776025,69888293,33229665,139893983,1364149328.419400,4104951356.080699,2390067541.993400,7859168226.493499,328884,419943,363259,1112086
2022-01-25,BYX Equities (Y),85024462,62559468,56554824,204138754,2602605198.735700,4844057205.841599,2765261638.410101,10211924042.987400,819627,382001,665775,1867403
2022-01-25,BZX Equities (Z),293217038,289969436,252524533,835711007,13350593790.183298,26595550104.097400,18103849964.074093,58049993858.354791,3630103,2201881,3326579,9158563
2022-01-24,NYSE American (A),27872141,48650000,18668906,95191047,1251696993.081600,1916197371.671300,1387463425.079900,4555357789.832800,294797,216737,221029,732563
2022-01-24,NASDAQ BX (B),30923768,38831743,42329881,112085392,1773823166.453000,3991586264.289801,4546916209.406398,10312325640.149199,554487,371886,698829,1625202
2022-01-24,NYSE National (C),60834359,61662604,43519391,166016354,1831919975.534600,2844427818.595699,1993969569.737399,6670317363.867698,669580,340930,499007,1509517
2022-01-24,FINRA / Nasdaq TRF Chicago (DB),16283927,5274844,21999816,43558587,614168777.271700,277266591.786800,1706320173.242301,2597755542.300801,69305,20817,115565,205687
2022-01-24,FINRA / NYSE TRF (DN),355424382,191196292,555691815,1102312489,13573513891.042205,9000730963.478299,30014959558.264564,52589204412.785068,2174816,651136,2737992,5563944
2022-01-24,FINRA / Nasdaq TRF Carteret (DQ),2083673363,1295228363,2343260113,5722161839,101289095652.879224,92185070777.901198,153019523614.516477,346493690045.296899,10843941,4476363,11091150,26411454
2022-01-24,MIAX Pearl (H),59159504,93736032,41764387,194659923,1803904217.269900,5570905447.781899,3317730829.641501,10692540494.693300,542164,513904,449819,1505887
2022-01-24,EDGA Equities (J),106938405,161229733,97228744,365396882,4637349802.703300,10333945643.747797,6971896188.054803,21943191634.505900,1393390,1264860,1302032,3960282
2022-01-24,EDGX Equities (K),423874021,245087382,426762672,1095724075,15527285803.566600,19648027005.985298,26740441410.253891,61915754219.805789,3648325,1863015,3984254,9495594
2022-01-24,LTSE (L),3977,5600,176083,185660,1389714.310000,798920.000000,19364191.830000,21552826.140000,29,6,1011,1046
2022-01-24,NYSE Chicago (M),27516536,12914276,18586849,59017661,2442496402.787100,2421207676.828001,5076692843.942902,9940396923.558003,141539,5923,112245,259707
2022-01-24,NYSE (N),1493447886,140434609,117977048,1751859543,80157154278.894395,11705194830.479998,8405123258.426800,100267472367.801193,7348407,690269,1036668,9075344
2022-01-24,NYSE Arca (P),363578100,789728582,553133371,1706440053,16358000310.431696,68826467586.198396,46038182298.200290,131222650194.830382,3812903,4414038,6006665,14233606
2022-01-24,NASDAQ (Q),835431579,695974556,1786388660,3317794795,41109108836.994498,64230713288.951829,143909460749.146810,249249282875.093137,10322874,5841383,16489623,32653880
2022-01-24,Members Exchange (U),282683274,249853143,242635941,775172358,7758687912.511698,18750169321.830394,11430866349.091506,37939723583.433598,2215409,1284275,2015350,5515034
2022-01-24,Investors Exchange (V),223148039,57902526,180757873,461808438,13895640444.435803,4748543200.034697,16378941363.691302,35023125008.161802,2607344,354310,2226443,5188097
2022-01-24,NASDAQ PSX (X),49670559,97670818,50230745,197572122,1823892230.079600,6865365533.499103,3803246521.485600,12492504285.064303,442029,663620,552867,1658516
2022-01-24,BYX Equities (Y),101017651,94422426,76153899,271593976,3177247116.147900,7317438712.052301,4465520013.555200,14960205841.755401,980172,593566,893633,2467371
2022-01-24,BZX Equities (Z),386636872,408852624,381508497,1176997993,16995799663.273808,36631959201.247993,29907768385.022693,83535527249.544494,4777356,3180131,4982801,12940288
2022-01-21,NYSE American (A),21314811,42831197,15911813,80057821,964871267.057500,1959218626.146100,1239701251.287800,4163791144.491400,219742,176736,173424,569902
2022-01-21,NASDAQ BX (B),23530724,25833610,32703655,82067989,1359823307.294900,2896346558.180299,3032417243.752699,7288587109.227898,437716,233662,547719,1219097
2022-01-21,NYSE National (C),53117781,54092327,38814811,146024919,1457885801.172000,2433702703.727400,1607184656.795900,5498773161.695300,543153,273419,420794,1237366
2022-01-21,FINRA / Nasdaq TRF Chicago (DB),10883135,4654413,17931449,33468997,418654984.331900,209512110.344800,1390595436.767000,2018762531.443700,50260,17569,100077,167906
2022-01-21,FINRA / NYSE TRF (DN),267942119,157110168,484520393,909572680,10352227779.725199,6855608941.726600,25146914146.709697,42354750868.161496,1721201,470808,2308534,4500543
2022-01-21,FINRA / Nasdaq TRF Carteret (DQ),1684733701,1020771364,1973941988,4679447053,80159144446.023290,78066857701.974899,126290681350.129545,284516683498.127734,8833409,3248719,9619718,21701846
2022-01-21,MIAX Pearl (H),47795180,73598648,37284421,158678249,1489447385.790300,4861966728.843601,2602034351.064801,8953448465.698702,448715,361730,388165,1198610
2022-01-21,EDGA Equities (J),84414731,108241776,83606845,276263352,3776777249.804900,7883519681.724001,6625124360.387401,18285421291.916302,1111984,844411,1150782,3107177
2022-01-21,EDGX Equities (K),315179831,174335886,356065645,845581362,12220815923.080503,13819511006.003011,22497217557.119593,48537544486.203107,2832618,1191851,3253408,7277877
2022-01-21,LTSE (L),319,70917,26128,97364,385738.800000,1887510.150000,1137980.020000,3411228.970000,11,20,85,116
2022-01-21,NYSE Chicago (M),30493328,11379053,22001759,63874140,2358359369.828200,1493820474.628000,5496395714.868801,9348575559.325001,74101,3296,65798,143195
2022-01-21,NYSE (N),1291724823,107341141,95368247,1494434211,73907603675.979006,9434066232.650197,6249731921.243701,89591401829.872904,5632381,449821,794900,6877102
2022-01-21,NYSE Arca (P),273919531,580414056,432063371,1286396958,12897032656.354208,49623512678.189545,36541170506.237796,99061715840.781549,2907367,2984016,4663881,10555264
2022-01-21,NASDAQ (Q),635393905,482323807,1498719552,2616437264,33191791311.058405,45907883112.149705,124561862365.591397,203661536788.799507,8024971,3938239,13059004,25022214
2022-01-21,Members Exchange (U),235695312,196218078,219556784,651470174,6883883844.225298,15679112211.164398,11366398471.080405,33929394526.470101,1865433,995276,1820681,4681390
2022-01-21,Investors Exchange (V),182460958,43081520,154069240,379611718,11705663433.006701,3795175609.722300,14146114242.584197,29646953285.313198,2204104,280325,1909653,4394082
2022-01-21,NASDAQ PSX (X),39969074,72778567,45082241,157829882,1485815642.315900,5051880734.763799,3416209329.417400,9953905706.497099,361529,447955,499630,1309114
2022-01-21,BYX Equities (Y),80850708,69132393,66248491,216231592,2473451974.930600,5239760868.237897,3550637122.398401,11263849965.566898,817002,403815,770343,1991160
2022-01-21,BZX Equities (Z),309684453,286741976,296916206,893342635,14271007687.587401,26584981063.140102,24030038383.350700,64886027134.078203,3800925,2077321,3891881,9770127
2022-01-20,NYSE American (A),17793932,27585525,14049856,59429313,875504018.603000,1419631941.274700,1020820086.372300,3315956046.250000,198248,130106,154121,482475
2022-01-20,NASDAQ BX (B),20313594,19155115,25382155,64850864,1159228191.420800,2205211528.288899,2359482921.714401,5723922641.424100,364964,150536,414289,929789
2022-01-20,NYSE National (C),43110567,42785463,32902554,118798584,1292218830.106400,2045878858.455300,1196389485.070100,4534487173.631800,470770,199857,348245,1018872
2022-01-20,FINRA / Nasdaq TRF Chicago (DB),8583651,3571464,15843912,27999027,347256826.270500,148906636.094000,967155223.440400,1463318685.804900,41046,11683,74327,127056
2022-01-20,FINRA / NYSE TRF (DN),234378352,130802948,482267288,847448588,8925968982.933599,5928064055.904101,19856337187.782602,34710370226.620302,1392304,357679,1890805,3640788
2022-01-20,FINRA / Nasdaq TRF Carteret (DQ),1529023929,783466022,1878584015,4191073966,74763364211.247216,49873243085.971495,98741212567.358065,223377819864.576776,7598136,2351996,7920286,17870418
2022-01-20,MIAX Pearl (H),38195302,51884228,27505793,117585323,1272942263.642600,3812880131.898800,1982148835.978400,7067971231.519800,393609,236521,301058,931188
2022-01-20,EDGA Equities (J),68644181,69803736,63164652,201612569,3177402994.731200,5166678138.688299,3977282201.061600,12321363334.481099,951564,531431,861643,2344638
2022-01-20,EDGX Equities (K),268439971,121026320,322500804,711967095,10420239112.284397,9078555179.773900,16114840225.048905,35613634517.107202,2351150,759160,2561229,5671539
2022-01-20,LTSE (L),36856,600,10699,48155,2745768.180000,13279.000000,1918613.660000,4677660.840000,26,3,113,142
2022-01-20,NYSE Chicago (M),19150578,16103460,18839956,54093994,1055274438.149100,1793680646.719000,3866250403.847999,6715205488.716099,49497,3152,45493,98142
2022-01-20,NYSE (N),941529291,76295277,73522795,1091347363,52141989372.074995,6188057218.254600,4142666427.780800,62472713018.110395,4396462,292435,577092,5265989
2022-01-20,NYSE Arca (P),227379828,395430118,374446631,997256577,10734441093.944199,34318517341.206098,26233519552.519108,71286477987.669405,2346750,2027728,3656223,8030701
2022-01-20,NASDAQ (Q),528912778,309771484,1126727685,1965411947,27596628133.326100,29343110982.678105,80012720671.068584,136952459787.072789,6622655,2424202,10116920,19163777
2022-01-20,Members Exchange (U),192659947,124276714,196508493,513445154,5886401792.241700,9533281843.935198,7878167830.099700,23297851466.276598,1552165,602077,1504953,3659195
2022-01-20,Investors Exchange (V),158903041,34375056,131599124,324877221,10097011516.717800,2848077868.847200,10404054045.058399,23349143430.623399,1983023,232861,1652153,3868037
2022-01-20,NASDAQ PSX (X),32083030,46023708,35354710,113461448,1169971957.770200,3476368256.695901,2165090641.373700,6811430855.839801,290976,239266,368580,898822
2022-01-20,BYX Equities (Y),66249192,55443056,53094023,174786271,2149039952.933000,4236975757.725700,2555111745.822701,8941127456.481401,705880,314104,610776,1630760
2022-01-20,BZX Equities (Z),245482127,179771564,229753905,655007596,11509755725.300799,16802022875.753103,15679000435.596999,43990779036.650901,3113859,1277294,2952530,7343683
2022-01-19,NYSE American (A),16277582,29225720,12116005,57619307,772555641.051700,989341176.442100,849753495.957400,2611650313.451200,180227,133937,142218,456382
2022-01-19,NASDAQ BX (B),20567013,19309998,23430364,63307375,1123286889.635000,1822705118.622200,2030032936.239200,4976024944.496400,360034,154163,407188,921385
2022-01-19,NYSE National (C),42199231,37869153,28120954,108189338,1231052793.513400,1719411875.025600,1019926311.860600,3970390980.399600,452916,177924,327306,958146
2022-01-19,FINRA / Nasdaq TRF Chicago (DB),8463540,3475748,14980608,26919896,359456829.312500,148238727.520800,1038746924.582000,1546442481.415300,41287,13045,75296,129628
2022-01-19,FINRA / NYSE TRF (DN),231050952,134052939,429512505,794616396,9355813342.602799,6027137131.289097,19850135966.222407,35233086440.114303,1366301,379678,1782754,3528733
2022-01-19,FINRA / Nasdaq TRF Carteret (DQ),1422354139,754937208,1694985110,3872276457,71679300031.078097,49923777088.888934,91501398627.342706,213104475747.309737,7229000,2423933,7426174,17079107
2022-01-19,MIAX Pearl (H),38010226,51391568,25182299,114584093,1247840274.870300,3536178780.154301,1656629562.917500,6440648617.942101,380158,232746,284978,897882
2022-01-19,EDGA Equities (J),67492190,69303920,61820400,198616510,3174910570.554200,4284839828.021202,4114464406.300400,11574214804.875802,942750,504100,871415,2318265
2022-01-19,EDGX Equities (K),260701717,123805425,288929463,673436605,10142125475.790895,8359885336.050500,15166181174.283302,33668191986.124697,2290752,767007,2428738,5486497
2022-01-19,LTSE (L),181711,1017,8134,190862,1313660.700000,459347.070000,150383.890000,1923391.660000,26,26,60,112
2022-01-19,NYSE Chicago (M),34093562,9090031,21154190,64337783,2650276869.393599,1437225148.354200,4290676543.397900,8378178561.145699,61491,3516,57550,122557
2022-01-19,NYSE (N),942101686,70574447,70280791,1082956924,54100129815.038002,5478812233.761000,4359874502.481200,63938816551.280202,4318560,264276,580758,5163594
2022-01-19,NYSE Arca (P),215518735,409112842,352128383,976759960,10314726882.708498,31996312572.824889,24940488801.587603,67251528257.120990,2249511,1992792,3518667,7760970
2022-01-19,NASDAQ (Q),501776253,303873398,1048926923,1854576574,26714241924.243103,25785404793.186607,79587873187.484892,132087519904.914602,6309907,2370242,9721188,18401337
2022-01-19,Members Exchange (U),189831342,130205739,180029604,500066685,5699798291.993899,9516821708.549802,7524071211.962600,22740691212.506301,1528742,643994,1434479,3607215
2022-01-19,Investors Exchange (V),142711622,33207687,118701954,294621263,9469831323.179702,2490127973.521600,8991940725.004203,20951900021.705505,1820011,223642,1509598,3553251
2022-01-19,NASDAQ PSX (X),27307303,44982873,31659194,103949370,942289951.348900,2958649224.488300,1981829856.806100,5882769032.643300,256052,235821,345227,837100
2022-01-19,BYX Equities (Y),65283795,53726109,47346174,166356078,2006020100.910000,3857485773.846200,2322069193.731200,8185575068.487400,665164,295378,580992,1541534
2022-01-19,BZX Equities (Z),239823365,180426165,216028765,636278295,11161945291.102204,15718658167.253690,14678390178.040404,41558993636.396298,2945405,1241414,2779426,6966245
2022-01-18,NYSE American (A),17244527,27880634,12959844,58085005,868464818.326200,1180478023.227800,948115628.258700,2997058469.812700,198981,123522,147006,469509
2022-01-18,NASDAQ BX (B),21994417,19391487,25250449,66636353,1274461298.813000,1972008673.396200,2294699996.734801,5541169968.944001,380969,152856,405522,939347
2022-01-18,NYSE National (C),43621220,41030145,32941599,117592964,1387673257.083000,1846033802.793600,1243954610.125900,4477661670.002500,474375,194568,339872,1008815
2022-01-18,FINRA / Nasdaq TRF Chicago (DB),11155046,4216889,18039807,33411742,492923288.616400,185189475.890400,1099081382.561400,1777194147.068200,58603,16355,89353,164311
2022-01-18,FINRA / NYSE TRF (DN),231716348,113753477,458162325,803632150,10016297221.204707,4958910619.300002,17923192125.087096,32898399965.591805,1621483,408332,2021679,4051494
2022-01-18,FINRA / Nasdaq TRF Carteret (DQ),1515976285,741989918,1812112147,4070078350,80917625059.096080,51740360567.151253,97295179449.872749,229953165076.120082,8132295,2670217,8154775,18957287
2022-01-18,MIAX Pearl (H),44306603,52556089,31718279,128580971,1340833667.885200,3650473803.984001,2564915756.004600,7556223227.873801,397878,235823,306607,940308
2022-01-18,EDGA Equities (J),70091873,70100881,67254353,207447107,3493994217.831100,4337331764.465099,4672490538.991600,12503816521.287799,991406,520048,911400,2422854
2022-01-18,EDGX Equities (K),275976095,113272867,309323475,698572437,11399951453.950395,8587120897.024598,15087979561.890288,35075051912.865281,2481663,770861,2491233,5743757
2022-01-18,LTSE (L),34097,200,5805,40102,4650348.910000,4428.000000,895110.860000,5549887.770000,18,1,62,81
2022-01-18,NYSE Chicago (M),10104538,8667181,12140899,30912618,854491356.800500,1534812947.080000,2948117348.303800,5337421652.184300,63142,4105,57682,124929
2022-01-18,NYSE (N),1042803452,67649459,69438866,1179891777,62363844237.838692,5797879433.976799,4343944556.127702,72505668227.943193,4455135,275039,586156,5316330
2022-01-18,NYSE Arca (P),233919369,406615540,414209005,1054743914,11712941560.107402,33601764761.764213,24895078465.293299,70209784787.164914,2502173,2097959,3692780,8292912
2022-01-18,NASDAQ (Q),537226912,308497270,1176963590,2022687772,29375554976.346206,28167884886.972209,87514287097.580151,145057726960.898566,6759056,2430397,9783698,18973151
2022-01-18,Members Exchange (U),188629284,119472223,177254203,485355710,5910843276.898600,9106000794.955800,7410505319.274601,22427349391.129001,1543127,596152,1422933,3562212
2022-01-18,Investors Exchange (V),155646990,32266379,130504629,318417998,10501863683.059700,2631024832.119900,10064900800.857698,23197789316.037298,1947483,218116,1643116,3808715
2022-01-18,NASDAQ PSX (X),32126114,47621188,35473832,115221134,1248920071.188700,3221229577.396201,2284650956.401300,6754800604.986201,308396,237460,370096,915952
2022-01-18,BYX Equities (Y),67169481,50729560,56407704,174306745,2240604241.151300,3955966362.943698,2674187393.016500,8870757997.111498,716822,288775,624485,1630082
2022-01-18,BZX Equities (Z),248963625,179258153,220639136,648860914,12396325102.182601,16126729022.793302,15193600210.551896,43716654335.527799,3142414,1253634,2818845,7214893
2022-01-14,NYSE American (A),15491381,24585744,11725338,51802463,798039459.730000,934797494.917200,774615877.424200,2507452832.071400,175563,118349,128622,422534
2022-01-14,NASDAQ BX (B),18185230,15161140,20974199,54320569,1159996473.194200,1654141071.753801,2018286195.147399,4832423740.095400,348753,127689,350134,826576
2022-01-14,NYSE National (C),37298430,33174288,26993947,97466665,1198979974.085300,1528355338.357000,1067817366.578599,3795152679.020899,420547,163229,302735,886511
2022-01-14,FINRA / Nasdaq TRF Chicago (DB),7607021,3067177,13619891,24294089,357603305.621200,134235737.032500,997882229.693900,1489721272.347600,41048,11350,66392,118790
2022-01-14,FINRA / NYSE TRF (DN),239255302,118874888,406200626,764330816,10544733783.193203,4583827167.604101,17692593212.117493,32821154162.914797,1451097,340423,1685311,3476831
2022-01-14,FINRA / Nasdaq TRF Carteret (DQ),1431148903,661158465,1582918934,3675226302,76308383593.977543,41058843815.407876,87844473727.319612,205211701136.705031,7273967,2172569,6880151,16326687
2022-01-14,MIAX Pearl (H),42151955,51321432,34438965,127912352,1299838775.647100,3510598671.874401,1909199169.262799,6719636616.784300,372255,226799,269711,868765
2022-01-14,EDGA Equities (J),62785358,62047111,59634964,184467433,3313710588.523000,3850162111.545001,4236797997.241700,11400670697.309701,922080,480322,845611,2248013
2022-01-14,EDGX Equities (K),256666839,104422194,265673172,626762205,11198575103.791703,7687765142.826800,14675134058.130500,33561474304.749003,2307571,689165,2203780,5200516
2022-01-14,LTSE (L),2871,1307,2018,6196,577354.550000,29002.330000,30538.320000,636895.200000,13,9,17,39
2022-01-14,NYSE Chicago (M),10679544,9058051,18107935,37845530,1115826615.724600,1669737329.710000,4521596791.322399,7307160736.756999,44485,2228,43315,90028
2022-01-14,NYSE (N),893617614,63810366,64814646,1022242626,55623595999.000313,5145514550.112601,3840266143.524101,64609376692.637015,4122386,250229,518353,4890968
2022-01-14,NYSE Arca (P),210573276,357786936,322177723,890537935,10927848919.914705,29885207716.735904,23281800367.655583,64094857004.306192,2263320,1844779,3185139,7293238
2022-01-14,NASDAQ (Q),486542879,273146032,982069067,1741757978,27873039277.522315,25886456325.108597,77005923099.440492,130765418702.071404,6210146,2281659,8902850,17394655
2022-01-14,Members Exchange (U),175282438,116961785,180187201,472431424,5861695479.397201,8795921798.964100,7191166613.617700,21848783891.979001,1472785,567919,1309476,3350180
2022-01-14,Investors Exchange (V),141462756,28266486,109207241,278936483,10129199544.554098,2197307127.952701,9044257675.075099,21370764347.581898,1730109,193341,1400323,3323773
2022-01-14,NASDAQ PSX (X),26368927,44440675,28373699,99183301,1005083340.047700,2966139687.520801,1836011425.143900,5807234452.712401,253643,220168,293608,767419
2022-01-14,BYX Equities (Y),56602055,43068967,47168882,146839904,2028310694.875400,3412550798.884200,2321518282.818898,7762379776.578498,609125,257440,516357,1382922
2022-01-14,BZX Equities (Z),226770459,162559652,199740496,589070607,11739418664.931800,15258372362.980296,15172073891.112494,42169864919.024590,2870667,1192806,2586927,6650400
2022-01-13,NYSE American (A),14580006,22799677,10590862,47970545,728431490.360500,913720046.862100,896998367.722300,2539149904.944900,155898,106261,120416,382575
2022-01-13,NASDAQ BX (B),20684694,15693801,21066954,57445449,1129475915.721700,1715175743.113500,2336255267.603600,5180906926.438800,349556,120989,370963,841508
2022-01-13,NYSE National (C),37654979,32145393,25605374,95405746,1120776605.953100,1448811339.813000,1057988321.124300,3627576266.890400,389151,153959,268666,811776
2022-01-13,FINRA / Nasdaq TRF Chicago (DB),9031047,3174903,13382177,25588127,418766624.673200,136459475.486900,1092158200.695900,1647384300.856000,45501,11361,70699,127561
2022-01-13,FINRA / NYSE TRF (DN),248744941,113502029,413085515,775332485,10180177911.305400,4620677831.712299,20527011710.370694,35327867453.388393,1414768,329591,1775019,3519378
2022-01-13,FINRA / Nasdaq TRF Carteret (DQ),1400020068,645798281,1571675713,3617494062,70241977629.050182,43131059541.448195,96035773715.536795,209408810886.035172,6895290,2021382,7116688,16033360
2022-01-13,MIAX Pearl (H),43312452,41474089,24172506,108959047,1265311518.929300,3749039679.819698,1853864277.238300,6868215475.987298,354968,203435,271071,829474
2022-01-13,EDGA Equities (J),62561854,53406756,56506655,172475265,2960638185.727100,3286875615.900601,4112166930.532603,10359680732.160304,870118,405375,791217,2066710
2022-01-13,EDGX Equities (K),264474892,100173161,274339720,638987773,11326374578.523098,7072263760.174902,17017283706.529499,35415922045.227499,2236370,620628,2358940,5215938
2022-01-13,LTSE (L),12157,642,18084,30883,736322.000000,51003.820000,2122073.930000,2909399.750000,8,6,78,92
2022-01-13,NYSE Chicago (M),11695290,8317036,9221498,29233824,734146611.325200,1351513826.597000,1785663310.516100,3871323748.438300,44938,2529,48617,96084
2022-01-13,NYSE (N),840913502,56203365,61328064,958444931,48309676976.312597,4463730476.033300,4358689532.820002,57132096985.165899,3865744,220263,520409,4606416
2022-01-13,NYSE Arca (P),208905892,326243201,323768173,858917266,10422635454.100101,26106183170.056803,24036145539.828108,60564964163.985012,2098110,1636569,3238560,6973239
2022-01-13,NASDAQ (Q),468927501,244528915,965042447,1678498863,25165115072.762905,21935542095.934505,79827880798.413605,126928537967.111015,5640151,1952919,8864397,16457467
2022-01-13,Members Exchange (U),179091352,107914729,158143450,445149531,5344848634.823900,7574444733.560098,7184908749.804604,20104202118.188602,1331766,497785,1262492,3092043
2022-01-13,Investors Exchange (V),137582301,27086443,109647014,274315758,9307055119.533602,2199617033.913800,9624575284.961097,21131247438.408499,1579340,178108,1362137,3119585
2022-01-13,NASDAQ PSX (X),26777397,39146258,26150287,92073942,975701189.481000,2565136270.380100,1847512851.294300,5388350311.155400,242261,186610,295863,724734
2022-01-13,BYX Equities (Y),57099488,41569401,43479921,142148810,1857177429.181300,3519883953.300699,2514006694.196399,7891068076.678398,582924,236369,520547,1339840
2022-01-13,BZX Equities (Z),219669891,146680354,194800335,561150580,10839529352.713398,12841361013.958602,16127332490.115300,39808222856.787300,2679414,993943,2574787,6248144
2022-01-12,NYSE American (A),14832233,24601632,10580477,50014342,718287930.850500,756729101.178900,687680533.579700,2162697565.609100,178030,112453,128773,419256
2022-01-12,NASDAQ BX (B),18385531,16239946,20638004,55263481,1026521382.977200,1672854765.648100,1899112361.823900,4598488510.449200,341628,131967,354659,828254
2022-01-12,NYSE National (C),38068860,33752548,28352934,100174342,1126342206.882900,1562664290.786700,1002108713.756000,3691115211.425600,408290,153364,269949,831603
2022-01-12,FINRA / Nasdaq TRF Chicago (DB),8432296,2899727,13393430,24725453,367746504.272100,131849549.114300,998869002.209400,1498465055.595800,40255,11866,68103,120224
2022-01-12,FINRA / NYSE TRF (DN),217949898,112698577,411434573,742083048,8496155137.916903,4886064748.140402,18475803588.525895,31858023474.583200,1206053,315793,1540042,3061888
2022-01-12,FINRA / Nasdaq TRF Carteret (DQ),1349456301,688227821,1674309051,3711993173,68070894241.091192,41082291379.386787,87841290860.485597,196994476480.963576,6538586,2086812,6528082,15153480
2022-01-12,MIAX Pearl (H),34810338,36775293,34603268,106188899,1022252622.577300,2892272645.140599,2642299880.074301,6556825147.792200,305765,176589,254866,737220
2022-01-12,EDGA Equities (J),58157814,51525292,52165942,161849048,2767323361.112000,2956477405.438601,3486222680.446799,9210023446.997400,850638,381613,717399,1949650
2022-01-12,EDGX Equities (K),235751911,93078363,254276704,583106978,9590321776.068499,6183377261.514901,15050215428.225003,30823914465.808403,2022164,619620,2113220,4755004
2022-01-12,LTSE (L),3134,400,30413,33947,257023.000000,8862.000000,2471057.830000,2736942.830000,6,2,72,80
2022-01-12,NYSE Chicago (M),10396496,8574435,9877417,28848348,863997792.734600,1237249334.610000,1860041333.612301,3961288460.956901,36178,2336,36192,74706
2022-01-12,NYSE (N),853563727,52653191,60016993,966233911,49712743919.121897,4109851689.458700,3408413821.814300,57231009430.394897,3618746,224411,475776,4318933
2022-01-12,NYSE Arca (P),187288259,314224519,309870412,811383190,9248511318.590397,24242961105.480793,21123085527.625501,54614557951.696691,1955426,1525124,2989349,6469899
2022-01-12,NASDAQ (Q),440523440,227647377,943757407,1611928224,23598729208.262298,20277667923.310001,72671099338.673428,116547496470.245727,5506853,1842106,8099403,15448362
2022-01-12,Members Exchange (U),169475177,103930877,168610780,442016834,4901863761.614600,6847685549.542900,6682731249.462101,18432280560.619601,1305972,483612,1226379,3015963
2022-01-12,Investors Exchange (V),128404704,26981170,98681300,254067174,8536050681.487301,1891089817.835100,7912115201.720402,18339255701.042803,1563601,189693,1259821,3013115
2022-01-12,NASDAQ PSX (X),25183166,32041714,28102963,85327843,871271487.916100,2313440195.956800,1600385764.210599,4785097448.083499,226522,158356,275498,660376
2022-01-12,BYX Equities (Y),55403951,41067425,44002921,140474297,1696776079.226200,3092615210.309303,2093421849.565300,6882813139.100803,574578,247018,487266,1308862
2022-01-12,BZX Equities (Z),202139064,127807321,175831829,505778214,9764687010.170901,11055172520.562699,12957494697.804402,33777354228.538002,2527516,887647,2272603,5687766
2022-01-11,NYSE American (A),14960119,26282162,11123130,52365411,722285642.968000,987268926.579600,714758736.960400,2424313306.508000,166607,120171,122946,409724
2022-01-11,NASDAQ BX (B),17739621,16701889,22968885,57410395,1049423050.925800,1724620573.025700,2079461183.824799,4853504807.776299,320439,134926,347322,802687
2022-01-11,NYSE National (C),39904004,33496357,32656960,106057321,1186180056.185600,1541709208.152700,1194198302.688100,3922087567.026400,421735,159860,299760,881355
2022-01-11,FINRA / Nasdaq TRF Chicago (DB),7836151,2936187,16656832,27429170,356470889.145700,108578061.460500,959552325.659400,1424601276.265600,39869,10734,72105,122708
2022-01-11,FINRA / NYSE TRF (DN),218214606,118884495,387145901,724245002,8428807690.773896,4467790394.457699,19258391176.510910,32154989261.742505,1272897,334783,1620497,3228177
2022-01-11,FINRA / Nasdaq TRF Carteret (DQ),1343118481,711433791,1626898131,3681450403,68024687739.385911,42479456019.790018,91144535357.812060,201648679116.987989,6864301,2085416,6777529,15727246
2022-01-11,MIAX Pearl (H),36661237,35480798,29485532,101627567,1102925432.939100,2560899903.366899,1983311943.057100,5647137279.363099,326568,177468,249718,753754
2022-01-11,EDGA Equities (J),62240953,59593509,58904053,180738515,2960187357.571400,3513534330.722401,3700191567.516299,10173913255.810100,878214,432797,746358,2057369
2022-01-11,EDGX Equities (K),247430831,108340849,263935579,619707259,9794964132.321000,7216895200.808702,14907296085.963908,31919155419.093610,2076223,625666,2087334,4789223
2022-01-11,LTSE (L),5,300,802,1107,27625.000000,6642.000000,158512.790000,192779.790000,1,1,15,17
2022-01-11,NYSE Chicago (M),8277503,9375687,10941479,28594669,706844046.587100,1176783434.940000,1652969716.615100,3536597198.142200,39359,2653,39142,81154
2022-01-11,NYSE (N),852790090,63971971,67250929,984012990,50022436664.724005,4859621554.670000,4049868782.779499,58931927002.173504,3865883,246300,515155,4627338
2022-01-11,NYSE Arca (P),202577798,348529468,330323760,881431026,9937464657.717894,27070002758.558800,23897068088.663594,60904535504.940288,2086068,1654263,3155776,6896107
2022-01-11,NASDAQ (Q),460041143,263142686,974884790,1698068619,24531864099.286389,23165339950.387000,76031521396.907100,123728725446.580489,5820722,2063493,8619052,16503267
2022-01-11,Members Exchange (U),166093804,123330328,175113566,464537698,5028752118.036500,7889479722.259100,7013539864.823599,19931771705.119199,1364344,553975,1262935,3181254
2022-01-11,Investors Exchange (V),132872870,26834812,108668419,268376101,9012489612.840899,2121872613.712500,8962549428.182000,20096911654.735399,1585907,170690,1325961,3082558
2022-01-11,NASDAQ PSX (X),23783403,36121095,28497060,88401558,844317719.246200,2337175303.630600,1624388335.071900,4805881357.948700,227510,184405,272999,684914
2022-01-11,BYX Equities (Y),58210015,44584373,54911066,157705454,1800077378.587200,3318747135.010999,2308369679.776100,7427194193.374299,595002,238210,513894,1347106
2022-01-11,BZX Equities (Z),208843756,144286698,190352084,543482538,10070006858.232100,12666843017.595498,13700318690.572694,36437168566.400292,2675322,961330,2350714,5987366
2022-01-10,NYSE American (A),15966239,27284821,12505569,55756629,763267931.331300,1308687809.234900,889020142.308800,2960975882.875000,184860,131178,140970,457008
2022-01-10,NASDAQ BX (B),21096269,19098768,27079374,67274411,1252217538.579700,2004901690.808800,2539653118.504001,5796772347.892501,386835,156378,421918,965131
2022-01-10,NYSE National (C),42062043,41035015,40262984,123360042,1294388968.481600,1945697228.363800,1357965045.297400,4598051242.142800,484297,182467,363756,1030520
2022-01-10,FINRA / Nasdaq TRF Chicago (DB),10939020,3530925,21168572,35638517,431302162.765400,132001869.395300,1404147336.131500,1967451368.292200,49507,15255,104692,169454
2022-01-10,FINRA / NYSE TRF (DN),216619546,118341369,460307197,795268112,9269194691.741503,5243884964.869200,21905230620.670213,36418310277.280916,1472707,388834,2110155,3971696
2022-01-10,FINRA / Nasdaq TRF Carteret (DQ),1429648855,737997945,1894309325,4061956125,77574499234.864976,56327867339.420940,111484623278.691941,245386989852.977857,7768727,2567095,8521022,18856844
2022-01-10,MIAX Pearl (H),40827064,42822805,36593486,120243355,1297232531.094400,3550574445.266300,2425364427.441999,7273171403.802699,385283,223942,322735,931960
2022-01-10,EDGA Equities (J),70418652,74911684,71865465,217195801,3438991581.203400,4813456197.886899,4820123517.367799,13072571296.458098,1041214,539003,973682,2553899
2022-01-10,EDGX Equities (K),265431123,119558056,323126152,708115331,10717501066.143597,8922252283.179000,18802713841.947395,38442467191.269992,2437217,817852,2777390,6032459
2022-01-10,LTSE (L),1154,0,4952,6106,481238.390000,0.000000,1767883.100000,2249121.490000,15,0,56,71
2022-01-10,NYSE Chicago (M),8761471,5333738,10006922,24102131,847754024.533500,1652941626.340000,1865922603.819800,4366618254.693300,53030,2630,55607,111267
2022-01-10,NYSE (N),1007056959,79420522,82244667,1168722148,60749773012.436801,6087210780.896200,4884919597.236899,71721903390.569900,4593543,318898,635063,5547504
2022-01-10,NYSE Arca (P),221712951,399695046,410977373,1032385370,10963629935.274698,34381158211.167287,29768850156.706186,75113638303.148171,2382502,2155252,3942399,8480153
2022-01-10,NASDAQ (Q),519370860,309601009,1225830192,2054802061,28433243942.259595,29353335653.013215,99722023357.205555,157508602952.478365,6773410,2547490,10703057,20023957
2022-01-10,Members Exchange (U),176933453,143328538,215864696,536126687,5425672622.800000,9379272957.395500,8496547026.341197,23301492606.536697,1453111,660083,1450046,3563240
2022-01-10,Investors Exchange (V),148892920,30437612,138907004,318237536,10556514484.908100,2694573560.579301,12035651578.847997,25286739624.335398,1821618,198258,1618421,3638297
2022-01-10,NASDAQ PSX (X),26018529,41569584,39219432,106807545,994759695.835300,2885523420.765599,2252711354.066400,6132994470.667299,267417,219723,355209,842349
2022-01-10,BYX Equities (Y),58418412,49477456,68020291,175916159,2058954748.882600,4197775790.005098,2987071646.129500,9243802185.017198,663983,292112,630298,1586393
2022-01-10,BZX Equities (Z),231641680,174467906,238891909,645001495,11721416131.988099,16257310579.971694,17560123182.349694,45538849894.309487,3122723,1248967,3055353,7427043
2022-01-07,NYSE American (A),16353421,21405880,10651381,48410682,782441758.263300,756895838.392000,686799024.313700,2226136620.969000,171987,97834,121533,391354
2022-01-07,NASDAQ BX (B),18160515,16410978,20788771,55360264,1019465464.642100,1801053909.183099,2020126143.557599,4840645517.382798,322619,129474,340204,792297
2022-01-07,NYSE National (C),40746587,31517355,28583713,100847655,1203737452.775800,1500787209.474900,1052070227.787200,3756594890.037900,429290,143267,281729,854286
2022-01-07,FINRA / Nasdaq TRF Chicago (DB),7648781,2765944,13742200,24156925,379625711.985600,129597313.128400,1008511812.901300,1517734838.015300,39290,10301,68793,118384
2022-01-07,FINRA / NYSE TRF (DN),214749901,96702959,385113423,696566283,9087851096.364201,4520923913.980399,18006034992.904792,31614810003.249392,1308758,300332,1660324,3269414
2022-01-07,FINRA / Nasdaq TRF Carteret (DQ),1371111318,585382181,1536709775,3493203274,69928672879.121983,44566755352.340401,88988003934.010627,203483432165.473011,6955836,1991748,6970119,15917703
2022-01-07,MIAX Pearl (H),35787922,30822707,28475162,95085791,1143153243.515300,2789261762.831501,2235767336.196200,6168182342.543001,340174,184121,270172,794467
2022-01-07,EDGA Equities (J),65843331,59215339,56419504,181478174,3142290303.245800,3582440868.845199,3789613321.985198,10514344494.076197,930940,427885,781958,2140783
2022-01-07,EDGX Equities (K),241049998,89270774,256101891,586422663,10459163778.511800,6802096024.637800,15358766093.602607,32620025896.752207,2102023,585099,2259033,4946155
2022-01-07,LTSE (L),3863,0,0,3863,814635.590000,0.000000,0.000000,814635.590000,13,0,0,13
2022-01-07,NYSE Chicago (M),14255718,9263047,17293077,40811842,1300339935.970600,1495523240.303000,2794827075.260100,5590690251.533700,39577,3373,41915,84865
2022-01-07,NYSE (N),902988175,57461539,64171467,1024621181,55178095192.363797,4410278193.981202,3927268303.430599,63515641689.775598,3857015,227150,526224,4610389
2022-01-07,NYSE Arca (P),196311611,308574376,320673091,825559078,10072617388.990800,24648226733.340402,24265134582.075597,58985978704.406799,2034093,1535401,3282148,6851642
2022-01-07,NASDAQ (Q),458085080,230326114,970448274,1658859468,25539315147.788197,20771733126.903703,77631300080.608070,123942348355.299970,5598893,1833915,8444862,15877670
2022-01-07,Members Exchange (U),172436473,108324326,165350239,446111038,5359607919.145500,7088213297.165496,7185606776.783001,19633427993.093997,1378984,492604,1305712,3177300
2022-01-07,Investors Exchange (V),134121110,24566710,103761738,262449558,9483784619.597403,1990358661.225000,8730345372.345598,20204488653.168001,1659589,164719,1373938,3198246
2022-01-07,NASDAQ PSX (X),25530130,33473036,29835061,88838227,956181182.283500,2589685323.871000,1888716438.446100,5434582944.600600,257525,170506,293059,721090
2022-01-07,BYX Equities (Y),56742512,40386667,47722353,144851532,1739129889.055100,3112846342.088599,2200254390.414400,7052230621.558099,574118,230079,485126,1289323
2022-01-07,BZX Equities (Z),209587338,128795895,182238517,520621750,10823956441.248202,11695461454.164003,14463504366.782000,36982922262.194205,2514221,921554,2303583,5739358
2022-01-06,NYSE American (A),16375282,26163745,11343852,53882879,774391040.638700,923164014.505300,751170485.443200,2448725540.587200,175474,127646,133074,436194
2022-01-06,NASDAQ BX (B),20583365,17667869,25241044,63492278,1189975795.539500,2012532010.026601,2516859069.912902,5719366875.479003,354169,157066,416183,927418
2022-01-06,NYSE National (C),42970172,36743947,30732384,110446503,1217915482.300100,1686681131.952200,1097394918.110700,4001991532.363000,431931,171976,305778,909685
2022-01-06,FINRA / Nasdaq TRF Chicago (DB),8467007,3084081,15675826,27226914,434385023.994200,159141938.560900,1155760847.008800,1749287809.563900,44576,12029,80549,137154
2022-01-06,FINRA / NYSE TRF (DN),221289904,111329927,450487160,783106991,9141116960.709906,4799320286.101800,19931107801.535598,33871545048.347304,1355294,326197,1816963,3498454
2022-01-06,FINRA / Nasdaq TRF Carteret (DQ),1371500485,658646026,1742331919,3772478430,70925768174.771797,43070405964.614981,98343222324.454932,212339396463.841710,7076185,2237904,7594448,16908537
2022-01-06,MIAX Pearl (H),35451057,35640710,26563795,97655562,1177198938.367900,3031738915.366001,1843496262.014800,6052434115.748701,357019,201697,282437,841153
2022-01-06,EDGA Equities (J),70308504,68459633,62245292,201013429,3319057525.033700,4059066484.931401,4247990936.650101,11626114946.615202,964984,496603,865900,2327487
2022-01-06,EDGX Equities (K),256148039,105723964,304431691,666303694,10742792757.242499,7834219809.190400,16647636368.836194,35224648935.269093,2307455,690618,2566064,5564137
2022-01-06,LTSE (L),8356,1870,47627,57853,1075587.890000,32313.600000,343044.120000,1450945.610000,16,3,22,41
2022-01-06,NYSE Chicago (M),12752818,8428133,13466587,34647538,1318805969.406500,1439375916.510000,3151542821.525201,5909724707.441701,43840,2501,47815,94156
2022-01-06,NYSE (N),912652242,69986602,69853177,1052492021,53134475018.491097,5401899332.201902,4364483985.935300,62900858336.628299,4292652,296946,591011,5180609
2022-01-06,NYSE Arca (P),208068693,363828310,373009147,944906150,10623952748.731604,28474176085.935318,27225365881.640607,66323494716.307529,2192918,1808372,3699381,7700671
2022-01-06,NASDAQ (Q),498412374,279301667,1067550925,1845264966,27848347643.033201,25071809896.631715,83971705180.553073,136891862720.217989,6364052,2235291,9867194,18466537
2022-01-06,Members Exchange (U),167970957,138753028,191608282,498332267,5316815778.505800,8542934172.816098,7882194729.846800,21741944681.168698,1424366,608185,1445812,3478363
2022-01-06,Investors Exchange (V),143211360,28558193,119217452,290987005,9955398191.114403,2616797100.074600,10202719666.565100,22774914957.754103,1745517,189895,1569194,3504606
2022-01-06,NASDAQ PSX (X),26630967,41510646,29278823,97420436,992799561.978100,2946071523.706900,1968599162.529200,5907470248.214200,270210,206072,334457,810739
2022-01-06,BYX Equities (Y),59669549,44841331,55085789,159596669,1981770481.648600,3740466634.814101,2470234233.324300,8192471349.787001,644308,265917,582723,1492948
2022-01-06,BZX Equities (Z),222816475,151879810,202649349,577345634,11398560935.205497,14092694130.822607,15812613411.353697,41303868477.381801,2945703,1106942,2795152,6847797
2022-01-05,NYSE American (A),17433172,29898988,12299140,59631300,888935841.385300,1257142609.129400,925585262.944300,3071663713.459000,194206,132627,140027,466860
2022-01-05,NASDAQ BX (B),22238526,18351338,24559541,65149405,1280366040.021100,2080112400.855600,2413807607.874301,5774286048.751001,389687,151034,391572,932293
2022-01-05,NYSE National (C),47514897,37669214,33714046,118898157,1443239708.935100,1665663361.566800,1154284106.101800,4263187176.603700,501248,172863,318811,992922
2022-01-05,FINRA / Nasdaq TRF Chicago (DB),9881526,3529841,15088334,28499701,488485854.581300,172954364.422000,1124145954.819500,1785586173.822800,52160,13523,84873,150556
2022-01-05,FINRA / NYSE TRF (DN),268391005,131096223,479887427,879374655,10954491621.897005,5724924661.436406,20799751545.090305,37479167828.423716,1572347,385087,2014902,3972336
2022-01-05,FINRA / Nasdaq TRF Carteret (DQ),1574351070,754572216,1829187107,4158110393,80904056123.502116,53227110633.158768,103178901517.314039,237310068273.974923,8021295,2410852,8169968,18602115
2022-01-05,MIAX Pearl (H),38065837,32732362,29198001,99996200,1287952388.041000,3190303583.294500,2448105125.060000,6926361096.395500,381312,193635,285658,860605
2022-01-05,EDGA Equities (J),79862003,65553503,63997719,209413225,3807662362.836000,3958196868.088999,4372242662.060198,12138101892.985197,1094745,485118,879541,2459404
2022-01-05,EDGX Equities (K),307252539,120323981,327309860,754886380,12931284214.604701,8328973465.692899,18272968538.806702,39533226219.104302,2735308,776614,2837068,6348990
2022-01-05,LTSE (L),5028,0,30536,35564,175784.950000,0.000000,4735589.020000,4911373.970000,5,0,124,129
2022-01-05,NYSE Chicago (M),9638754,10840549,13476043,33955346,839537767.317300,2251248069.569400,3417079039.631700,6507864876.518400,38334,2377,39506,80217
2022-01-05,NYSE (N),1031385225,70440259,76788294,1178613778,61992844958.398312,5758879796.145100,4681966016.678399,72433690771.221811,4806309,306246,607385,5719940
2022-01-05,NYSE Arca (P),232833883,389811900,380595791,1003241574,11527740908.261302,30634028038.170408,28255348477.755488,70417117424.187198,2414744,1934660,3860934,8210338
2022-01-05,NASDAQ (Q),559306814,286871787,1133145680,1979324281,30670528262.879502,26171881730.935496,93051202874.299736,149893612868.114734,7016582,2257193,10563487,19837262
2022-01-05,Members Exchange (U),185448049,131267805,188925213,505641067,5808953144.055100,8455313153.522498,7775647356.887601,22039913654.465199,1524688,610208,1455488,3590384
2022-01-05,Investors Exchange (V),147986053,30538374,115931963,294456390,10118717875.415700,2709973595.335000,10654305522.942106,23482996993.692806,1751041,194365,1459242,3404648
2022-01-05,NASDAQ PSX (X),34135303,38043937,32989014,105168254,1315365451.151500,2822034582.811000,2144142114.710700,6281542148.673200,343050,190275,351206,884531
2022-01-05,BYX Equities (Y),67336650,51443591,59415651,178195892,2174152563.720900,4037738067.731501,2797082628.003100,9008973259.455501,705882,284313,595138,1585333
2022-01-05,BZX Equities (Z),254901071,162594313,215314654,632810038,12808802136.107499,14507112585.041807,17430029532.142601,44745944253.291907,3302681,1148961,3027405,7479047
2022-01-04,NYSE American (A),17709752,21824086,11576633,51110471,990398632.340200,698237171.299900,815769530.917500,2504405334.557600,201888,103364,141792,447044
2022-01-04,NASDAQ BX (B),21254637,15368187,22941666,59564490,1273619055.789300,1480420979.807001,2434067228.641999,5188107264.238300,383881,124584,397906,906371
2022-01-04,NYSE National (C),45498828,31221129,30340122,107060079,1459896486.224700,1448814474.265300,1188477152.986500,4097188113.476500,502259,147792,323645,973696
2022-01-04,FINRA / Nasdaq TRF Chicago (DB),9609590,2829071,17516662,29955323,441858207.304900,136547908.750800,1176862337.032000,1755268453.087700,51258,10538,89052,150848
2022-01-04,FINRA / NYSE TRF (DN),272999278,107202567,555185597,935387442,11974477893.138805,4501685755.368599,21625404335.982703,38101567984.490107,1603356,340469,2020341,3964166
2022-01-04,FINRA / Nasdaq TRF Carteret (DQ),1542658211,598098652,1923970268,4064727131,81477473745.951727,44237909243.856104,102568551627.850930,228283934617.658761,8065404,2229829,7999653,18294886
2022-01-04,MIAX Pearl (H),45526629,25644461,30115137,101286227,1383786833.611100,2218097510.317000,2737899118.795800,6339783462.723900,387746,157179,312254,857179
2022-01-04,EDGA Equities (J),70287588,48722196,59566731,178576515,3715912296.128400,2948579062.567000,3949554741.183902,10614046099.879302,1050606,376194,844209,2271009
2022-01-04,EDGX Equities (K),290590834,88451512,346949441,725991787,13212082853.590900,6253209091.735499,18404567679.688387,37869859625.014786,2616340,580758,2664959,5862057
2022-01-04,LTSE (L),3743,104,3431,7278,507527.810000,8916.120000,115441.910000,631885.840000,19,2,13,34
2022-01-04,NYSE Chicago (M),10662205,5897867,10093494,26653566,834517227.122900,1122950378.355000,2209338465.759200,4166806071.237100,42228,3216,39815,85259
2022-01-04,NYSE (N),950302750,48102436,73785590,1072190776,58136216786.560602,3799799966.393600,4160026968.995799,66096043721.950001,4448841,217776,574520,5241137
2022-01-04,NYSE Arca (P),223571801,294963357,384451000,902986158,11825955213.112000,22823456583.209493,25739160001.785784,60388571798.107277,2362186,1490764,3603050,7456000
2022-01-04,NASDAQ (Q),535451773,221186944,1056577341,1813216058,31053291758.243990,19769035682.646295,82991433085.839531,133813760526.729816,6785427,1759682,9635766,18180875
2022-01-04,Members Exchange (U),175012503,95008862,210060533,480081898,5899396820.025600,6669190637.392299,7090405941.342901,19658993398.760800,1491984,476751,1405348,3374083
2022-01-04,Investors Exchange (V),145171814,24728761,111424402,281324977,10224670231.053997,2197742452.674100,9996592199.372499,22419004883.100596,1721847,180331,1430817,3332995
2022-01-04,NASDAQ PSX (X),29113906,28814777,28814709,86743392,1215922242.496100,2037489189.850001,2017014738.223500,5270426170.569601,292038,137770,310454,740262
2022-01-04,BYX Equities (Y),64136382,42565566,54645861,161347809,2122812617.415100,3439751623.576001,2550812443.620501,8113376684.611602,679193,243857,570354,1493404
2022-01-04,BZX Equities (Z),233611504,114476122,203093574,551181200,12757390429.613899,10354476900.943002,15764837443.873996,38876704774.430897,3135550,822932,2744879,6703361
2022-01-03,NYSE American (A),14190370,23946012,9778211,47914593,709211133.654700,743226369.121900,630063690.446400,2082501193.223000,155189,102031,110382,367602
2022-01-03,NASDAQ BX (B),15151446,13875723,19259447,48286616,878839102.295600,1373139808.375600,1888263016.791800,4140241927.463000,276631,111066,315618,703315
2022-01-03,NYSE National (C),31723440,27263090,25277601,84264131,953511299.320500,1331410433.675700,1021049775.680899,3305971508.677099,358857,130967,252150,741974
2022-01-03,FINRA / Nasdaq TRF Chicago (DB),7468660,2625040,13268414,23362114,351381378.885500,130312937.748400,984329852.815600,1466024169.449500,40159,9228,75167,124554
2022-01-03,FINRA / NYSE TRF (DN),198138148,108640041,442900438,749678627,7986606814.779898,4570576795.238100,18891965822.442710,31449149432.460708,1299855,338622,1832592,3471069
2022-01-03,FINRA / Nasdaq TRF Carteret (DQ),1282878996,671011564,1704479206,3658369766,64976173433.066887,49344565643.753489,99137633032.705702,213458372109.526078,6652884,2119160,7162450,15934494
2022-01-03,MIAX Pearl (H),38718486,26855268,27733220,93306974,1030537531.767600,2161637326.741201,2418340023.194300,5610514881.703101,318434,156602,280512,755548
2022-01-03,EDGA Equities (J),51313861,45258624,48098848,144671333,2571418271.784200,2813029929.693000,3238561007.046800,8623009208.524000,776622,337614,688524,1802760
2022-01-03,EDGX Equities (K),231163508,85790430,283774108,600728046,9755470985.820597,6072858904.173000,16396013796.383799,32224343686.377396,2039098,542966,2264009,4846073
2022-01-03,LTSE (L),35520,202,1013,36735,1208135.380000,4549.440000,84829.280000,1297514.100000,24,2,8,34
2022-01-03,NYSE Chicago (M),9709444,6476117,10264491,26450052,706458918.486800,833330957.080000,1780706487.732700,3320496363.299500,39573,3042,41090,83705
2022-01-03,NYSE (N),844999964,48299659,60669378,953969001,49390757467.919203,3802232653.774900,3152659865.968800,56345649987.662903,3671634,213442,485774,4370850
2022-01-03,NYSE Arca (P),176449853,309344161,327676021,813470035,8358470007.959802,24303411749.596290,22553232575.633492,55215114333.189584,1855631,1410084,3100877,6366592
2022-01-03,NASDAQ (Q),420857807,206243230,951474522,1578575559,22629688306.346402,19457896118.650398,73848575482.338237,115936159907.335037,5370863,1637574,8123964,15132401
2022-01-03,Members Exchange (U),149683892,87218581,173106519,410008992,4537252935.457300,5829434638.267200,6029776975.980301,16396464549.704801,1257748,420003,1253840,2931591
2022-01-03,Investors Exchange (V),108251540,22946838,90536456,221734834,7262919783.764900,1980858835.986000,8213687456.384897,17457466076.135797,1371949,152890,1200840,2725679
2022-01-03,NASDAQ PSX (X),20599046,27153402,25481116,73233564,773653717.420400,2109630157.830200,1447552861.354400,4330836736.605000,217510,140030,249338,606878
2022-01-03,BYX Equities (Y),44985551,36145849,42035056,123166456,1487129978.853800,2911629509.535801,2121562797.571701,6520322285.961302,512833,210892,476102,1199827
2022-01-03,BZX Equities (Z),184703802,114394600,174152365,473250767,9298317278.379899,10401619015.845902,13469734402.699692,33169670696.925493,2459266,797400,2281728,5538394
